alu	?Are?are
hmd	A-Hmao
apq	A-Pucikwar
aot	A'tong
aiw	Aari
aas	Aasax
utp	Aba
abg	Abaga
abf	Abai Sungai
abm	Abanyom
aau	Abau
abq	Abaza
aba	Ab?
abe	Abenaki
abp	Abenlen Ayta
aum	Abewa
abi	Abidji
bsa	Abinomn
axb	Abipon
ash	Abishira
ab	Abkhaz
aob	Abom
abo	Abon
abr	Abron
ado	Abu
aah	Abu' Arapesh
abn	Abua
abz	Abui
kgr	Abun
abl	Abung
abu	Abure
mgj	Abureni
fra-aca	Acadian French
tpx	Acatepec Me'phaa
ace	Acehnese
aca	Achagua
acn	Achang
yif	Ache
guq	Ach?
acz	Acheron
acr	Achi
ach	Acholi
acu	Achuar
acv	Achumawi
acs	Acro?
adb	Adabe
xad	Adai
ads	Adamorobe Sign Language
adn	Adang
adq	Adangbe
ada	Adangme
adp	Adap
tiu	Adasen
ade	Adele
adh	Adhola
adi	Adi
adj	Adioukrou
ort	Adivasi Oriya
gas	Adiwasi Garasia
ajg	Adja
adt	Adnyamathanha
adr	Adonara
adu	Aduge
ady	Adyghe
adz	Adzera
aez	Aeka
awi	Aekyom
xae	Aequian
aeq	Aer
aal	Afade
aa	Afar
afg	Afghan Sign Language
aft	Afitti
ulf	Afra
afh	Afrihili
af	Afrikaans
afs	Afro-Seminole Creole
agd	Agarabi
agi	Agariya
agc	Agatu
avo	Agavotaguerra
agq	Aghem
ahh	Aghu
gtu	Aghu Tharrnggala
agx	Aghul
xag	Aghwan
aif	Agi
kit	Agob
ibm	Agoi
agu	Aguacateco
aga	Aguano
agr	Aguaruna
aug	Aguna
msm	Agusan Manobo
agn	Agutaynen
yay	Agwagwune
ahn	?h?n
aha	Ahanta
thm	Aheu
ahr	Ahirani
aho	Ahom
aht	Ahtna
nfd	Ahwai
aih	Ai-Cham
aix	Aighon
tba	Aikan?
mwg	Aiklep
aiq	Aimaq
ail	Aimele
aim	Aimol
aic	Ainbai
ain	Ainu
aki	Aiome
air	Airoran
aio	Aiton
nfl	Aiwoo
aja	Aja
ajw	Ajawa
aji	Aji?
cpc	Ajy?ninka Apurucayali
akq	Ak
soh	Aka
abj	Aka-Bea
akm	Aka-Bo
aci	Aka-Cari
akx	Aka-Kede
aky	Aka-Kol
ack	Aka-Kora
ak	Akan
acl	Akar-Bale
aks	Akaselem
ake	Akawaio
aik	Ake
keu	Akebu
tsr	Akei
aeu	Akeu
ahk	Akha
akv	Akhvakh
akk	Akkadian
sia	Akkala Sami
akl	Aklanon
akt	Akolet
bss	Akoose
miw	Akoye
akf	Akpa
ibe	Akpes
afi	Akrukay
ayk	Akuku
aku	Akum
aqz	Akuntsu
ako	Akurio
bey	Akuwagel
akw	Akwa
syy	Al-Sayyid Bedouin Sign Language
alw	Alaba
akz	Alabama
dul	Alabat Island Agta
mim	Alacatlatzala Mixtec
ala	Alago
wbj	Alagwa
alk	Alak
amp	Alamblak
alj	Alangan
xln	Alanic
apv	Alapmunte
btz	Alas-Kluet Batak
alh	Alawa
sq	Albanian
sqk	Albanian Sign Language
xta	Alcozauca Mixtec
alf	Alege
gah	Alekano
gsw	Alemannic German
ale	Aleut
arq	Algerian Arabic
aao	Algerian Saharan Arabic
asp	Algerian Sign Language
alq	Algonquin
aiy	Ali
ald	Alladian
all	Allar
aid	Alngith
ypo	Alo Phola
zaq	Alo?pam Zapotec
aol	Alor
aes	Alsea
mte	Alu
xua	Alu Kurumba
aub	Alugu
aab	Alumu-Tesu
alp	Alune
yna	Aluo
alz	Alur
ems	Alutiiq
alr	Alutor
avd	Alviri-Vidari
aly	Alyawarr
amm	Ama
amq	Amahai
amc	Amahuaca
ali	Amaimon
aad	Amal
amn	Amanab
ama	Amanay?
aie	Amara
amr	Amarakaeri
aaz	Amarasi
zpo	Amatl?n Zapotec
rwm	Amba
amk	Ambai
aew	Ambakich
abc	Ambala Ayta
amv	Ambelau
ael	Ambele
alm	Amblong
amb	Ambo
abs	Ambonese Malay
aag	Ambrak
apo	Ambul
abt	Ambulas
amj	Amdang
adx	Amdo Tibetan
aey	Amele
ase	American Sign Language
ifa	Amganad Ifugao
am	Amharic
amy	Ami
ami	Amis
sem-amm	Ammonite
amo	Amo
alx	Amol
mbz	Amoltepec Mixtec
apg	Ampanang
aqd	Ampari Dogon
ajz	Amri Karbi
amt	Amto
adw	Amundava
amg	Amurdag
amu	Amuzgo
dti	Ana Tinga Dogon
anw	Anaang
akg	Anakalangu
anm	Anal
pda	Anam
aan	Anamb?
imi	Anamgura
bpo	Anasi
acb	?nc?
grc	Ancient Greek
xlg	Ancient Ligurian
xmk	Ancient Macedonian
xna	Ancient North Arabian
xzp	Ancient Zapotec
afd	Andai
ajn	Andajin
xaa	Andalusian Arabic
hca	Andaman Creole Hindi
ana	Andaqui
aod	Andarum
adg	Andegerebinha
anr	Andh
ani	Andi
bzb	Andio
anb	Andoa
ano	Andoque
anx	Andra-Hus
aty	Aneityum
anz	Anem
aby	Aneme Wake
myo	Anfillo
agm	Angaataha
aqt	Angait?
age	Angal
aoe	Angal Enen
akh	Angal Heneng
njm	Angami
anc	Angas
yli	Angguruk Yali
anp	Angika
avm	Angkamuthi
akb	Angkola Batak
rme	Angloromani
aoa	Angolar
agg	Angor
aog	Angoram
tnd	Angosturas Tunebo
awg	Anguthimri
ypn	Ani Phowa
blo	Anii
anf	Animere
aoi	Anindilyakwa
boj	Anjam
aak	Ankave
amx	Anmatyerre
fab	Annobonese
nun	Anong
anj	Anor
ans	Anserma
and	Ansus
ant	Antakarinya
aig	Antigua and Barbuda Creole English
gcf	Antillean Creole
anl	Anu
anu	Anuak
cko	Anufo
aui	Anuki
auq	Anus
aud	Anuta
any	Anyi
mtb	Anyin Morofo
njo	Ao
pni	Aoheng
aor	Aore
kbx	Ap Ma
xap	Apalachee
apy	Apala?
ena	Apali
mip	Apasco-Apoala Mixtec
apt	Apatani
api	Apiak?
apn	Apinay?
app	Apma
ahp	Aproumu Aizi
apu	Apurin?
apx	Aputai
xaq	Aquitanian
ard	Arabana
arl	Arabela
ar	Arabic
an	Aragonese
akr	Araki
rkw	Arakwal
atq	Aralle-Tabulahan
arc	Aramaic
aam	Aramanik
stk	Arammba
aaf	Aranadan
xrt	Aranama-Tamique
jbj	Arandai
aro	Araona
arp	Arapaho
arj	Arapaso
arr	Arara-Karo
xaj	Ararandew?ra
arw	Arawak
awt	Arawet?
awm	Arawum
aae	Arb?resh? Albanian
arv	Arbore
aqc	Archi
pka	Ardhamagadhi Prakrit
mwc	Are
aea	Areba
aem	Arem
aed	Argentine Sign Language
agj	Argobba
agf	Arguni
aqr	Arh?
aok	Arh?
arh	Arhuaco
aac	Ari
laz	Aribwatsa
ylu	Aribwaung
aai	Arifama-Miniafia
aqg	Arigidi
ark	Arikap?
ari	Arikara
ait	Arikem
xrn	Arin
luc	Aringa
aoh	Arma
xrm	Armazic
hy	Armenian
aen	Armenian Sign Language
rup	Aromanian
apr	Arop-Lokep
aps	Arop-Sissano
aia	Arosi
atz	Arta
aru	Arua
arx	Aru?
msy	Aruamu
aur	Aruek
lsr	Aruop
atx	Arutani
aat	Arvanitika Albanian
asz	As
mtv	Asaro'o
asd	Asas
cni	Ash?ninka
ahs	Ashe
cjo	Ash?ninka Pajonal
prq	Ash?ninka Peren?
ask	Ashkun
csh	Asho Chin
atn	Ashtiani
bno	Asi
asl	Asilulu
eiv	Askopan
asv	Asoa
as	Assamese
xss	Assan
sjg	Assangori
asb	Assiniboine
aii	Assyrian Neo-Aramaic
ast	Asturian
asa	Asu
psa	Asue Awyu
aua	Asumboa
zoo	Asunci?n Mixtepec Zapotec
asr	Asuri
atm	Ata
atd	Ata Manobo
aqp	Atakapa
amz	Atampaya
mib	Atatl?huca Mixtec
tay	Atayal
ate	Atemble
teo	Ateso
aph	Athpare
atk	Ati
atj	Atikamekw
aqm	Atohwaim
ato	Atong
aox	Atorada
atc	Atsahuaca
cch	Atsam
atw	Atsugewi
pkr	Attapady Kurumba
ati	Atti?
ocu	Atzingo Matlatzinca
avt	Au
auj	Augila
kud	Auhelawa
djk	Aukan
aul	Aulua
aux	Aur?
auh	Aushi
avs	Aushiri
asf	Auslan
aut	Austral
asw	Australian Aboriginal Sign Language
zma	Australian Manda
asq	Austrian Sign Language
gip	Austronesian Gimi
hob	Austronesian Mari
mhz	Austronesian Mor
smf	Auwe
auy	Auyana
auu	Auye
auo	Auyokawa
avv	Av?-Canoeiro
av	Avar
avn	Avatime
avb	Avau
tmb	Avava
ae	Avestan
avi	Avikam
avu	Avokaya
vwa	Awa (China)
awb	Awa (New Guinea)
kwi	Awa-Cuaiquer
awk	Awabakal
bcu	Awad Bing
awa	Awadhi
awo	Awak
aya	Awar
awx	Awara
awh	Awbono
bob	Aweer
awr	Awera
awe	Awet?
azo	Awing
awn	Awngi
kmn	Awtuw
yiu	Awu
aww	Awun
afu	Awutu
auw	Awyi
ahb	Axamb
yix	Axi Yi
ayd	Ayabadhu
vmy	Ayautla Mazatec
aye	Ayere
axe	Ayerrerenge
ayq	Ayi
yyz	Ayizi
ayb	Ayizo Gbe
ay	Aymara
aib	Aynu
zaf	Ayoquesco Zapotec
ayo	Ayoreo
ayu	Ayu
miy	Ayutla Mixtec
az	Azeri
aza	Azha
yiz	Azhe
tpc	Azoy? Me'phaa
kwb	Baa
drl	Baagandji
bvj	Baan
bqx	Baangi
bba	Baatonum
bbw	Baba
mbf	Baba Malay
bbz	Babalia Creole Arabic
bbm	Babango
bbk	Babanki
baa	Babatana
bcr	Babine
bav	Babungo
bzg	Babuza
bcy	Bacama
btj	Bacanese Malay
xbc	Bactrian
bhz	Bada
bfq	Badaga
bau	Badanchi
bde	Bade
bdz	Badeshi
khd	B?di Kanum
bia	Badimaya
bac	Badui
pbp	Badyara
bvd	Baeggu
pkc	Baekje
bvc	Baelelea
btr	Baetora
bfj	Bafanji
bwt	Bafaw-Balong
ksf	Bafia
bfd	Bafut
bcg	Baga Binari
bqf	Baga Kaloum
bgo	Baga Koga
bmd	Baga Manduri
bgm	Baga Mboteni
bsp	Baga Sitemu
bsv	Baga Soban?
ngd	Bagandou
bfy	Bagheli
bmi	Bagirmi
bqg	Bago-Kusuntu
bgq	Bagri
bpi	Bagupi
bqb	Bagusa
kva	Bagvalal
yha	Baha Buyang
bdw	Baham
bah	Bahamian Creole
abv	Baharna Arabic
bhv	Bahau
bjh	Bahinemo
bhj	Bahing
bdq	Bahnar
bsu	Bahonsuai
bdj	Bai
bbf	Baibai
bkx	Baikeno
bqh	Baima
bmx	Baimak
bcz	Bainouk-Gunyaamolo
bab	Bainouk-Gunyu?o
bcb	Bainouk-Samik
bsw	Baiso
fah	Baissa Fali
bjs	Bajan
bjm	Bajelani
bkc	Baka
bkq	Bakair?
bqz	Bakaka
bqi	Bakhtiari
bki	Baki
bkh	Bakoko
kme	Bakole
bbs	Bakpinka
bbu	Bakulung
bkr	Bakumpai
xkl	Bakung
bjw	Bakw?
bls	Balaesang
blw	Balangao
sse	Balangingi
bjt	Balanta-Ganja
ble	Balanta-Kentohe
blz	Balantak
blg	Balau
bdn	Baldemu
bcp	Bali
ban	Balinese
mhp	Balinese Malay
bgx	Balkan Gagauz Turkish
rmn	Balkan Romani
bqo	Balo
biz	Baloi
bft	Balti
rml	Baltic Romani
blq	Baluan-Pam
bal	Baluchi
bog	Bamako Sign Language
bbq	Bamali
bmo	Bambalang
ptu	Bambam
bm	Bambara
myf	Bambassi
baw	Bambili-Bambui
bce	Bamenyam
bcf	Bamu
bqt	Bamukumbit
bax	Bamum
bvm	Bamunka
bmg	Bamwe
bfk	Ban Khor Sign Language
bcw	Bana
vrt	Banam Bay
bjx	Banao Itneg
byz	Banaro
bnd	Banda
bpq	Banda Malay
liy	Banda-Bambari
bpd	Banda-Banda
bqk	Banda-Mbr?s
bfl	Banda-Nd?l?
yaj	Banda-Yangere
bza	Bandi
bqj	Bandial
bdy	Bandjalang
bxg	Bangala
nmj	Bangando-Ngombe
bgf	Bangandu
bbe	Bangba
bgz	Banggai
bjb	Banggarla
bni	Bangi
dba	Bangi Me
mfb	Bangka
bgj	Bangolan
bnx	Bangubangu
bsj	Bangwinji
bvv	Baniva
bwi	Baniwa
bjn	Banjarese
bxw	Bankagooma
dbw	Bankan Tey Dogon
abb	Bankon
bcm	Bannoni
bap	Bantawa
bfx	Bantayanon
bnq	Bantik
map-bms	Banyumasan
bci	Baoule
brd	Baraamu
bbb	Barai
baj	Barakai
kys	Baram Kayan
bbg	Barama
brm	Barambu
bmz	Baramu
brp	Barapasi
brs	Baras
bsn	Barasana
bpb	Barbacoas
boi	Barbare?o
gry	Barclayville Grebo
bcj	Bardi
bae	Bar?
bva	Barein
mlp	Bargam
bfa	Bari
mot	Bar?
bch	Bariai
bjc	Bariji
bxo	Barikanchi
bjk	Barok
bbi	Barombi
tbn	Barro Negro Tunebo
bpt	Barrow Point
bjz	Baruga
byr	Baruya
bwg	Barwe
bjf	Barzani Jewish Neo-Aramaic
bzw	Basa
bsl	Basa-Gumna
buj	Basa-Gurmana
bas	Basaa
bdb	Basap
byq	Basay
lel	Bashilele
bsg	Bashkardi
ba	Bashkir
bst	Basketo
eu	Basque
bsq	Bassa
bsr	Bassa-Kontagora
bsc	Bassari
bsi	Bassossi
bta	Bata
ayt	Bataan Ayta
ifb	Batad Ifugao
bya	Batak
bnm	Batanga
btq	Batek
btv	Bateri
bhm	Bathari
btc	Bati (Cameroon)
bvt	Bati (Indonesia)
bbl	Bats
btu	Batu
zbt	Batui
bay	Batuley
bbd	Bau
sne	Bau Bidayuh
bsf	Bauchi
brg	Baure
bge	Bauria
bxa	Bauro
bwk	Bauwaki
bvz	Bauzi
bar	Bavarian
bgr	Bawm Chin
mkq	Bay Miwok
bjy	Bayali
bvy	Baybayanon
byg	Baygo
byl	Bayono
bda	Bayot
bxj	Bayungu
bfr	Bazigar
beo	Beami
bea	Beaver
bfp	Beba
bzv	Bebe
beb	Bebele
bek	Bebeli
bxp	Bebil
tnr	Bedik
bjv	Bedjond
bed	Bedoanas
bkf	Beeke
bxq	Beele
beq	Beembe
bnz	Beezen
bby	Befang
bqv	Begbere-Ejar
bej	Beja
bei	Bekati'
bkv	Bekwarra
bkw	Bekwel
beg	Belait
bxb	Belanda Bor
bvi	Belanda Viri
be	Belarusian
byw	Belhariya
blm	Beli
bzj	Belize Kriol English
blc	Bella Coola
brw	Bellari
bem	Bemba
bmb	Bembe
dbt	Ben Tey Dogon
yun	Bena
bef	Benabena
bcq	Bench
bdp	Bende
bct	Bendi
bnv	Beneraf
nhb	Beng
bng	Benga
bn	Bengali
bgy	Benggoi
bqy	Bengkala Sign Language
bnu	Bentong
byd	Benyadu'
bue	Beothuk
bie	Bepour
brf	Bera
bxv	Berakou
bve	Berau Malay
lod	Berawan
brc	Berbice Creole Dutch
bkl	Berik
bit	Berinomo
bom	Berom
wti	Berta
byt	Berti
mhe	Besisi
bes	Besme
bep	Besoa
bfe	Betaf
bew	Betawi
byf	Bete
btt	Bete-Bendi
eot	Beti
xub	Betta Kurumba
kap	Bezhta
bhd	Bhadrawahi
bhx	Bhalay
bha	Bharia
btl	Bhatola
bgw	Bhatri
bht	Bhattiyali
bhe	Bhaya
bhy	Bhele
bhi	Bhilali
bhb	Bhili
bho	Bhojpuri
nes	Bhoti Kinnauri
bhu	Bhunjia
bif	Biafada
bdf	Biage
bhw	Biak
beh	Biali
bpv	Bian Marind
big	Biangai
byk	Biao
bmt	Biao Mon
bje	Biao-Jiao Mien
bth	Biatah Bidayuh
bcn	Bibaali
xbp	Bibbulman
bid	Bidiyo
bym	Bidyara
bjg	Bidyogo
bmc	Biem
bnk	Bierebo
brj	Bieria
biu	Biete
nmb	Big Nambas
bhc	Biga
xbe	Bigambal
bh	Bihari
bix	Bijori
bic	Bikaru
bcl	Bikol Central
byb	Bikya
bip	Bila
bql	Bilakura
kfs	Bilaspuri
bpz	Bilba
brz	Bilbil
bil	Bile
bll	Biloxi
blb	Bilua
bxf	Bilur
bhp	Bima
bhl	Bimin
bim	Bimoba
bmn	Bina
bxz	Binahari
bhg	Binandere
byj	Binawa
xbd	Bindal
bon	Bine
bpj	Binji
itb	Binongan Itneg
bne	Bintauna
bny	Bintulu
bkd	Binukid
bjr	Binumarien
biq	Bipi
brr	Birao
btf	Birgit
biy	Birhor
bzr	Biri
bqq	Biritai
brk	Birked
bvq	Birri
xbj	Birrpayi
brl	Birwa
ije	Biseni
bpy	Bishnupriya Manipuri
bwh	Bishuo
bnw	Bisis
bi	Bislama
bir	Bisorio
bib	Bissa
bzi	Bisu
bgk	Bit
brt	Bitare
mcc	Bitur
bwm	Biwat
byo	Biyo
bpm	Biyom
blp	Blablanga
art-bsp	Black Speech
bla	Blackfoot
bfh	Blafe
beu	Blagar
blr	Blang
byn	Blin
bgl	Bo
mae	Bo-Rukul
mux	Bo-Ung
bzn	Boano (Maluku)
bzl	Boano (Sulawesi)
bgb	Bobongko
bty	Bobot
boy	Bodo (Central Africa)
brx	Bodo (India)
gbj	Bodo Gadaba
bdv	Bodo Parja
bff	Bofi
bvw	Boga
boq	Bogaya
bux	Boghom
bqu	Boguru
bhn	Bohtan Neo-Aramaic
bzf	Boikin
ybk	Bokha
bqc	Boko
bus	Bokobaru
bdt	Bokoto
bky	Bokyi
bnp	Bola
art-blk	Bolak
bld	Bolango
bol	Bole
bvo	Bolgo
bli	Bolia
smk	Bolinao
bvl	Bolivian Sign Language
blv	Bolo
bkt	Boloki
bof	Bolon
bzm	Bolondo
blj	Bolongan
ply	Bolyu
bmf	Bom
boh	Boma
bml	Bomboli
bws	Bomboma
zmx	Bomitaba
bmq	Bomu
bmw	Bomwali
glc	Bon Gula
peh	Bonan
bou	Bondei
bfw	Bondo
kzc	Bondoukou Kulango
dbu	Bondum Dom Dogon
bna	Bonerate
bdg	Bonggi
bpg	Bonggo
bui	Bongili
bot	Bongo
bpu	Bongu
bok	Bonjo
bvg	Bonkeng
bop	Bonkiman
bnc	Bontoc
bnb	Bookan
bnl	Boon
bvf	Boor
boa	Bora
kvn	Border Kuna
gai	Borei
ksr	Borong
bor	Bor?ro
brn	Boruca
bwf	Boselewa
bqs	Bosngun
bmj	Bote-Majhi
bph	Botlikh
sbl	Botolan Sambal
nku	Bouna Kulango
bzo	Bozaba
aof	Bragat
brh	Brahui
bra	Braj
bzs	Brazilian Sign Language
kvl	Brek Karen
buq	Brem
brq	Breri
br	Breton
bzd	Bribri
bfi	British Sign Language
bro	Brokkat
sgt	Brokpake
bkk	Brokskat
plw	Brooke's Point Palawano
bpl	Broome Pearling Lugger Pidgin
kxd	Brunei
bsb	Brunei Bisaya
jid	Bu
bwx	Bu-Nao Bunu
bub	Bua
cbl	Bualkhaw Chin
box	Buamu
bvb	Bube
buw	Bubi
bbx	Bubia
stt	Budeh Stieng
btp	Budibud
bdx	Budong-Budong
buu	Budu
bdk	Budukh
bdm	Buduma
bja	Budza
bbh	Bugan
buk	Bugawac
bgt	Bughotu
bug	Buginese
sab	Buglere
bgg	Bugun
ubl	Buhi'non Bikol
bku	Buhid
bxh	Buhutu
byh	Bujhyal
sdo	Bukar-Sadung Bidayuh
bvk	Bukat
bhh	Bukhari
bvu	Bukit Malay
bkn	Bukitan
ape	Bukiyip
tkb	Buksa
bxk	Bukusu
xbo	Bulgar
bg	Bulgarian
bqn	Bulgarian Sign Language
bmp	Bulgebi
bwu	Buli (Ghana)
bzq	Buli (Indonesia)
buy	Bullom So
sti	Bulo Stieng
bum	Bulu (Cameroon)
bjl	Bulu (New Guinea)
bmv	Bum
byp	Bumaji
bvp	Bumang
aon	Bumbita Arapesh
kjz	Bumthangkha
buv	Bun
bvn	Buna
bck	Bunaba
bfn	Bunak
bdd	Bunama
bns	Bundeli
bqd	Bung
but	Bungain
xbg	Bunganditj
bkz	Bungku
wun	Bungu
dgb	Bunoge Dogon
bnn	Bunun
aus-bun	Bunurong
blf	Buol
bwr	Bura
mde	Bura Mabang
bys	Burak
bkg	Buraka
bvr	Burarra
bti	Burate
bxn	Burduna
bvh	Bure
bji	Burji
my	Burmese
bzu	Burmeso
mhs	Buru (Indonesia)
bqw	Buru (Nigeria)
bry	Burui
aip	Burumakok
bdi	Burun
bds	Burunge
bsk	Burushaski
bqr	Burusu
asi	Buruwai
bua	Buryat
bqp	Busa
bxs	Busam
bsm	Busami
bfg	Busang Kayan
buc	Bushi
buf	Bushoong
bso	Buso
bup	Busoa
dox	Bussa
bju	Busuu
kyb	Butbut Kalinga
xby	Butchulla
bnr	Butmas-Tur
btw	Butuanon
bhs	Buwal
byy	Buya
xpy	Buyeo
byi	Buyu
jiy	Buyuan Jinuo
bww	Bwa
bwd	Bwaidoka
tte	Bwanabwana
bwa	Bwatoo
bwe	Bwe Karen
bwl	Bwela
bwc	Bwile
bwz	Bwisi
bee	Byangsi
mkk	Byep
gkm	Byzantine Greek
dri	C'lela
msq	Caac
cjp	Cab?car
cbb	Cabiyar?
miu	Cacaloxtepec Mixtec
ccr	Cacaopera
roc	Cacgia Roglai
cbv	Cacua
cad	Caddo
ccd	Cafundo Creole
cbh	Cagua
cah	Cahuarano
chl	Cahuilla
zad	Cajonos Zapotec
ckx	Caka
cak	Cakchiquel
ckz	Cakchiquel-Quich? Mixed Language
cky	Cakfem-Mushere
grk-cal	Calabrian Greek
tbk	Calamian Tagbanwa
caw	Callawalla
rmq	Cal?
clu	Caluyanun
abd	Camarines Norte Agta
xba	Camba
mcu	Cameroon Mambila
wes	Cameroon Pidgin
rab	Camling
cml	Campalagian
sro	Campidanese Sardinian
kbh	Cams?
cmt	Camtho
xcc	Camunic
cbu	Candoshi-Shapra
ram	Canela
caz	Canichana
yue	Cantonese
cov	Cao Miao
kaq	Capanahua
cps	Capiznon
cpg	Cappadocian Greek
cot	Caquinte
caq	Car Nicobarese
cfd	Cara
cby	Carabayo
crf	Caramanta
cbc	Carapana
xcr	Carian
hns	Caribbean Hindustani
jvn	Caribbean Javanese
cbd	Carijona
crr	Carolina Algonquian
cal	Carolinian
rmc	Carpathian Romani
crx	Carrier
cbr	Cashibo-Cacataibo
cbs	Cashinahua
dgc	Casiguran Dumagat Agta
asc	Casuarina Coast Asmat
ca	Catalan
csc	Catalan Sign Language
chc	Catawba
cca	Cauca
cav	Cavine?a
cyb	Cayubaba
cay	Cayuga
xcy	Cayuse
sef	Cebaara Senoufo
ceb	Cebuano
xce	Celtiberian
cam	Cemuh?
cen	Cen
cns	Central Asmat
tzm	Central Atlas Tamazight
awu	Central Awyu
bca	Central Bai
zbc	Central Berawan
lbk	Central Bontok
agt	Central Cagayan Agta
dtp	Central Dusun
grv	Central Grebo
zch	Central Hongshuihe Zhuang
nch	Central Huasteca Nahuatl
hmc	Central Huishui Hmong
ckb	Central Kurdish
mwo	Central Maewo
zam	Central Mahuatl?n Zapoteco
pse	Central Malay
mxz	Central Masela
hmm	Central Mashan Hmong
maz	Central Mazahua
mel	Central Melanau
cmo	Central Mnong
nhn	Central Nahuatl
ncb	Central Nicobarese
ojc	Central Ojibwa
plc	Central Palawano
pbs	Central Pame
poo	Central Pomo
ncx	Central Puebla Nahuatl
sml	Central Sama
ess	Central Siberian Yupik
csm	Central Sierra Miwok
syb	Central Subanen
tgt	Central Tagbanwa
tar	Central Tarahumara
tuf	Central Tunebo
cet	Cent??m
cme	Cerma
caa	Ch'orti'
tjw	Chaap Wuurong
cbi	Chachi
cao	Ch?cobo
shu	Chadian Arabic
cds	Chadian Sign Language
cdy	Chadong
chg	Chagatai
ciy	Chaima
ckh	Chak
cli	Chakali
ccp	Chakma
cll	Chala
cld	Chaldean Neo-Aramaic
tgf	Chalikha
ceg	Chamacoco
cji	Chamalal
cdg	Chamari
ccg	Chamba Daka
ndi	Chamba Leko
cdh	Chambeali
can	Chambri
ccc	Chamicuro
ch	Chamorro
caj	Chan?
nbc	Chang
snq	Chango
cga	Changriwa
cna	Changthang
chx	Chantyal
cra	Chara
cdn	Chaudangsi
crv	Chaura
cbk	Chavacano
cbt	Chayahuita
mih	Chayuco Mixtec
xtb	Chazumba Mixtec
ruk	Che
ce	Chechen
mrn	Cheke Holo
xch	Chemakum
cjn	Chenapian
cde	Chenchu
cnu	Chenoua
cdm	Chepang
ycp	Chepya
cpn	Cherepon
chr	Cherokee
ych	Chesu
ctc	Chetco
cwg	Chewong
chy	Cheyenne
hne	Chhattisgarhi
ctn	Chhintange
cur	Chhulung
csd	Chiangmai Sign Language
cip	Chiapanec
chb	Chibcha
trs	Chicahuaxtla Triqui
ny	Chichewa
zpv	Chichicapan Zapotec
pei	Chichimeca-Jonaz
coh	Chichonyi-Chidzihana-Chikauma
cic	Chickasaw
cob	Chicomuceltec
dig	Chidigo
dug	Chiduruma
mii	Chigmecatitl?n Mixtec
clc	Chilcotin
csg	Chilean Sign Language
clh	Chilisso
csa	Chiltepec Chinantec
zoh	Chimalapa Zoque
cid	Chimariko
cbg	Chimila
cih	Chinali
cnb	Chinbon Chin
zh	Chinese
cpi	Chinese Pidgin English
csl	Chinese Sign Language
chh	Chinook
chn	Chinook Jargon
cap	Chipaya
chp	Chipewyan
cbe	Chipiajes
maq	Chiquihuitl?n Mazatec
cax	Chiquitano
apm	Chiricahua
nhd	Chirip?
cdf	Chiru
ctm	Chitimacha
cik	Chitkuli Kinnauri
tog	Chitonga
ctg	Chittagonian
the	Chitwania Tharu
iow	Chiwere
zpc	Choapan Zapotec
cgk	Chocangacakha
coz	Chochotec
cho	Choctaw
cdi	Chodri
nri	Chokri Naga
cjk	Chokwe
ctu	Chol
cht	Chol?n
cog	Chong
cda	Choni
cce	Chopi
xco	Chorasmian
nct	Chothe Naga
crw	Chrau
cje	Chru
cqd	Chuanqiandian Cluster Miao
cjv	Chuave
cvg	Chug
cac	Chuj
cuh	Chuka
ckt	Chukchi
cuw	Chukwa
clw	Chulym
ncu	Chumburung
cdj	Churahi
scb	Chut
chk	Chuukese
xcv	Chuvantsy
cv	Chuvash
chw	Chuwabu
cib	Ci Gbe
cia	Cia-Cia
ckl	Cibak
awc	Cicipu
cim	Cimbrian
mkx	Cinamiguin Manobo
cdr	Cinda-Regi-Tiyal
cie	Cineni
cin	Cinta Larga
asg	Cishingini
txt	Citak
tgd	Ciwogai
myz	Classical Mandaic
cmg	Classical Mongolian
nci	Classical Nahuatl
nwc	Classical Newari
qwc	Classical Quechua
syc	Classical Syriac
xct	Classical Tibetan
xcw	Coahuilteco
csi	Coast Miwok
kzj	Coastal Kadazan
kjc	Coastal Konjo
zca	Coatecas Altas Zapotec
naz	Coatepec Nahuatl
mco	Coatl?n Mixe
zps	Coatl?n Zapotec
miz	Coatzospan Mixtec
cod	Cocama-Cocamilla
coj	Cochimi
coc	Cocopa
coa	Cocos Islands Malay
crd	Coeur d'Alene
con	Cof?n
kog	Cogui
liw	Col
csn	Colombian Sign Language
gct	Colonia Tovar German
cof	Colorado
col	Columbia-Wenatchi
cco	Comaltepec Chinantec
com	Comanche
xcm	Comecrudo
art-com	Communicationssprache
cfg	Como Karim
coo	Comox
cno	Con
cnc	C??ng
csz	Coos
zoc	Copainal? Zoque
trc	Copala Triqui
cop	Coptic
coq	Coquille
crn	Cora
cry	Cori
kw	Cornish
co	Corsican
csr	Costa Rican Sign Language
mta	Cotabato Manobo
xcn	Cotoname
cow	Cowlitz
kox	Coxima
coy	Coyaima
pbf	Coyotepec Popoloca
toc	Coyutla Totonac
cr	Cree
mus	Creek
gme-cgo	Crimean Gothic
crh	Crimean Tatar
csq	Croatian Sign Language
mfn	Cross River Mbembe
cro	Crow
crz	Cruze?o
cua	Cua
csf	Cuban Sign Language
cub	Cubeo
cui	Cuiba
cul	Culina
cuo	Cumanagoto
xcb	Cumbric
cum	Cumeral
cuq	Cun
cug	Cung
cup	Cupe?o
xcu	Curonian
kpc	Curripaco
ccl	Cutchi-Swahili
cuv	Cuvok
xtu	Cuyamecalco Mixtec
cyo	Cuyunon
bwy	Cwi Bwamu
acy	Cypriot Arabic
cs	Czech
cse	Czech Sign Language
kzf	Da'a Kaili
dao	Daai Chin
lni	Daantanai'
dsh	Daasanach
dbq	Daba
dbr	Dabarre
dbe	Dabe
xdc	Dacian
mps	Dadibi
dbd	Dadiya
dgz	Daga
dgd	Dagaari Dioula
dgk	Dagba
dag	Dagbani
dec	Dagik
dgn	Dagoman
dlk	Dahalik
dal	Dahalo
das	Daho-Doo
dij	Dai
zhd	Dai Zhuang
drb	Dair
btd	Dairi Batak
bpa	Dakaka
dkk	Dakka
dak	Dakota
dka	Dakpakha
dlm	Dalmatian
bev	Daloa B?t?
dmm	Dama
dam	Damakawa
uhn	Damal
dac	Dambi
dml	Dameli
dms	Dampelas
dnj	Dan
dnr	Danaru
dnu	Danau
daq	Dandami Maria
daa	Dangal?at
thl	Dangaura Tharu
da	Danish
dsl	Danish Sign Language
aso	Dano
dnv	Danu
dhw	Danuwar
daz	Dao
dnd	Daonda
djc	Dar Daju Daju
daj	Dar Fur Daju
dau	Dar Sila Daju
dry	Darai
dar	Dargwa
xda	Darkinjung
dln	Darlong
drd	Darmiya
dro	Daro-Matu Melanau
xgm	Darumbal
dot	Dass
tcc	Datooga
dta	Daur
daw	Davawenyo
kwa	D?w
dww	Dawawa
ddw	Dawera-Daweloor
dwr	Dawro
dai	Day
dax	Dayi
dzd	Daza
dzg	Dazaga
dcc	Deccan
ded	Dedua
afn	Defaka
gbh	Defi Gbe
mzw	Deg
ing	Deg Xinag
dgu	Degaru
deg	Degema
dge	Degenan
deh	Dehwari
dek	Dek
row	Dela-Oenale
ntr	Delo
dem	Dem
dmx	Dema
dei	Demisa
dmy	Demta
tfn	Dena'ina
ddn	Dendi
dez	Dengese
dnk	Dengka
dny	Den?
dbb	Deno
anv	Denya
der	Deori
des	Desano
dso	Desiya
dee	Dewoin
def	Dezfuli
dgh	Dghwede
dhs	Dhaiso
dhl	Dhalandji
dhg	Dhangu
dhn	Dhanki
nfa	Dhao
xdk	Dharug
mki	Dhatki
dhi	Dhimal
dv	Dhivehi
dho	Dhodia
adf	Dhofari Arabic
ddr	Dhudhuroa
dhx	Dhungaloo
dhu	Dhurga
duj	Dhuwal
dia	Dia
mbd	Dibabawon Manobo
dby	Dibiyaso
dio	Dibo
bvx	Dibole
duy	Dicamay Agta
did	Didinga
dif	Dieri
mhu	Digaro-Mishmi
dur	Dii
cfa	Dijim-Bwilim
dil	Dilling
jma	Dima
dis	Dimasa
dii	Dimbong
dim	Dime
dmc	Dimir
mrx	Dineor
diz	Ding
din	Dinka
ddi	Diodio
gdl	Dirasha
dwa	Diri
dir	Dirim
dsi	Disa
tbz	Ditammari
dtd	Ditidaht
diu	Diudish
diy	Diuwe
xtd	Diuxi-Tilantongo Mixtec
dix	Dixon Reef
mdx	Dizin
djr	Djambarrpuyngu
djd	Djamindjung
djf	Djangun
djn	Djauan
djw	Djawi
djj	Djeebbana
dyi	Djimini Senoufo
dji	Djinang
djb	Djinba
djl	Djiwarli
kvo	Dobel
dob	Dobu
doe	Doe
dgg	Doga
dgx	Doghoro
dos	Dogos?
dgs	Dogoso
doi	Dogri
dgr	Dogrib
dbg	Dogul Dom Dogon
dbi	Doka
uya	Doko-Uyanga
dlg	Dolgan
dre	Dolpo
doa	Dom
dmk	Domaaki
rmt	Domari
dov	Dombe
doq	Dominican Sign Language
doy	Dompo
dof	Domu
dev	Domung
dok	Dondo
doh	Dong
doo	Dongo
kzh	Dongolawi
ddd	Dongotono
yik	Dongshanba Lalo
sce	Dongxiang
dds	Donno So Dogon
dde	Doondo
dor	Dori'o
wwo	Dorig
kqc	Doromu-Koki
drr	Dororo
doz	Dorze
dol	Doso
don	Doura
tds	Doutai
dow	Doyayo
dhv	Drehu
duu	Drung
dua	Duala
dup	Duano
dva	Duau
dub	Dubli
dmu	Dubu
ndu	Dugun
dbm	Duguri
dme	Dugwor
kbz	Duhwa
dud	Duka
nke	Duke
dbo	Dulbu
duz	Duli
dma	Duma
duf	Dumbea
dus	Dumi
dmv	Dumpas
dui	Dumun
duc	Duna
dng	Dungan
raa	Dungmali
duh	Dungra Bhil
dbv	Dungu
duo	Dupaninan Agta
drq	Dura
mvp	Duri
dbn	Duriankere
pci	Duruwa
dsn	Dusner
dun	Dusun Deyah
duq	Dusun Malang
duw	Dusun Witu
nl	Dutch
nds-nl	Dutch Low Saxon
dse	Dutch Sign Language
dux	Duungooma
dae	Duupa
duv	Duvle
dbp	Duwai
gve	Duwet
nnu	Dwang
dyy	Dyaabugay
dyb	Dyaberdyaber
dya	Dyan
dyn	Dyangadi
dbl	Dyirbal
dyd	Dyugun
dyu	Dyula
jen	Dza
dzl	Dzalakha
dzn	Dzando
bpn	Dzao Min
add	Dzodinka
dz	Dzongkha
dnn	Dz??ngoo
eee	E
yzg	E'ma Buyang
xtr	Early Tripuri
zbe	East Berawan
dmr	East Damar
fud	East Futuna
kjs	East Kewa
lma	East Limba
mky	East Makian
vme	East Masela
nle	East Nyala
tre	East Tarangan
yuy	East Yugur
acp	Eastern Acipa
aer	Eastern Arrernte
bgp	Eastern Balochi
gui	Eastern Bolivian Guaran?
ebk	Eastern Bontok
bru	Eastern Bru
ike	Eastern Canadian Inuktitut
cjm	Eastern Cham
azd	Eastern Durango Nahuatl
avl	Eastern Egyptian Bedawi Arabic
frs	Eastern Frisian
tge	Eastern Gorkha Tamang
ggn	Eastern Gurung
cly	Eastern Highland Chatino
otm	Eastern Highland Otomi
zeh	Eastern Hongshuihe Zhuang
nhe	Eastern Huasteca Nahuatl
hme	Eastern Huishui Hmong
xrb	Eastern Karaboro
ktv	Eastern Katu
eky	Eastern Kayah
kee	Eastern Keres
kqo	Eastern Krahn
yit	Eastern Lalu
lwl	Eastern Lawa
mgp	Eastern Magar
emk	Eastern Maninkakan
chm	Eastern Mari
emg	Eastern Meohang
mng	Eastern Mnong
emu	Eastern Muria
nea	Eastern Ngad'a
nos	Eastern Nisu
ojg	Eastern Ojibwa
kif	Eastern Parbate Kham
pez	Eastern Penan
peb	Eastern Pomo
hmq	Eastern Qiandong Miao
taj	Eastern Tamang
bnj	Eastern Tawbuid
muq	Eastern Xiangxi Miao
gbx	Eastern Xwla Gbe
igb	Ebira
xeb	Eblaite
ebr	Ebri?
ebg	Ebughu
ecs	Ecuadorian Sign Language
cbj	Ede Cabe
ica	Ede Ica
idd	Ede Idaca
ijj	Ede Ije
nqg	Ede Nago
awy	Edera Awyu
bin	Edo
etr	Edolo
xdm	Edomite
dbf	Edopi
efa	Efai
efe	Efe
efi	Efik
ofu	Efutop
ega	Ega
ego	Eggon
egy	Egyptian
arz	Egyptian Arabic
esl	Egyptian Sign Language
ehu	Ehueun
eip	Eipomek
eit	Eitiep
etu	Ejagham
eja	Ejamat
eka	Ekajuk
ekg	Ekari
khy	Ekele
eki	Eki
eke	Ekit
ekp	Ekpeye
zpp	El Alto Zapotec
elh	El Hugeirat
elo	El Molo
elx	Elamite
elm	Eleme
ele	Elepi
dlc	Elfdalian
ekm	Elip
elk	Elkei
art-elo	Eloi
zte	Elotepec Zapotec
afo	Eloyi
mrf	Elseng
elu	Elu
xly	Elymian
mmw	Emae
ema	Emai
emn	Eman
emb	Embaloh
bdc	Ember?-Baud?
cto	Ember?-Cat?o
cmi	Ember?-Cham?
tdc	Ember?-Tad?
ebu	Embu
enr	Emem
eme	Emerillon
egl	Emilian
emw	Emplawas
enc	En
unk	Enawen?-Naw?
end	Ende
enq	Enga
enn	Engenni
eno	Enggano
en	English
enl	Enlhet
ptt	Enrekang
enu	Enu
env	Enwan
enw	Enwang
enx	Enxet
gey	Enya
sja	Epena
xep	Epi-Olmec
epi	Epie
emy	Epigraphic Mayan
era	Eravallan
kjy	Erave
twp	Ere
ert	Eritai
erw	Erokwanas
err	Erre
emx	Erromintxela
ers	Ersu
erh	Eruwa
myv	Erzya
ish	Esan
mcq	Ese
ese	Ese Ejja
esh	Eshtehardi
ags	Esimbi
eo	Esperanto
esq	Esselen
ots	Estado de M?xico Otomi
et	Estonian
eso	Estonian Sign Language
esm	Esuma
etc	Etchemin
etb	Etebi
etx	Eten
ecr	Eteocretan
ecy	Eteocypriot
eth	Ethiopian Sign Language
ich	Etkywan
eto	Eton (Cameroon)
etn	Eton (Vanuatu)
ett	Etruscan
utr	Etulo
bzz	Evant
eve	Even
evn	Evenki
nou	Ewage-Notu
ee	Ewe
ewo	Ewondo
ext	Extremaduran
eya	Eyak
eza	Ezaa
faf	Fagani
azt	Faire Atta
faj	Faita
fai	Faiwol
gel	Fakkanci
fax	Fala
cfm	Falam Chin
fli	Fali
xfa	Faliscan
fam	Fam
fng	Fanagalo
bjp	Fanamaket
fak	Fang (Cameroon)
fan	Fang (Guinea)
fni	Fania
fat	Fanti
fmu	Far Western Muria
gur	Farefare
fo	Faroese
fqs	Fas
faa	Fasu
far	Fataleka
ddg	Fataluku
fau	Fayu
fmp	Fe'fe'
pdn	Fedan
agl	Fembe
kah	Fer
fer	Feroge
hif	Fiji Hindi
fj	Fijian
tlp	Filomena Mata-Coahuitl?n Totonac
yuw	Finisterre Yau
fi	Finnish
fse	Finnish Sign Language
fss	Finnish-Swedish Sign Language
fag	Finongan
fip	Fipa
fir	Firan
fiw	Fiwaga
vgt	Flemish Sign Language
fln	Flinders Island
flh	Foau
foi	Foi
ffi	Foia Foia
ppo	Folopa
fom	Foma
fon	Fon
fgr	Fongoro
fod	Foodo
frq	Forak
frd	Fordata
for	Fore
enf	Forest Enets
frt	Fortsenal
sac	Fox
zos	Francisco Le?n Zoque
frp	Franco-Proven?al
frk	Frankish
fr	French
sfb	French Belgian Sign Language
fsl	French Sign Language
fur	Friulian
ff	Fula
flr	Fuliiru
fun	Fulni?
fum	Fum
ula	Fungwa
fvr	Fur
fuu	Furu
fut	Futuna-Aniwa
fuy	Fuyug
fwa	Fw?i
fwe	Fwe
pym	Fyam
fie	Fyer
gaa	Ga
gqa	Ga'anda
gdg	Ga'dang
ttb	Gaa
tbi	Gaam
kbt	Gabadi
gbw	Gabi
gab	Gabri
xgf	Gabrielino-Fernande?o
gdk	Gadang
gad	Gaddang
gbk	Gaddi
ged	Gade
gda	Gade Lohar
gdh	Gadjerawang
gaj	Gadsup
gft	Gafat
gbu	Gagadu
gag	Gagauz
btg	Gagnoa B?t?
bfu	Gahri
gbf	Gaikundi
gic	Gail
gcn	Gaina
gap	Gal
glo	Galambu
xga	Galatian
gbi	Galela
gar	Galeya
car	Galibi Carib
gce	Galice
gl	Galician
xgl	Galindan
roa-gal	Gallo
sdn	Gallurese Sardinian
adl	Galo
gal	Galoli
kmc	Gam
kgj	Gamale Kham
gma	Gambera
wof	Gambian Wolof
kld	Gamilaraay
gbl	Gamit
gak	Gamkonora
gmv	Gamo
bte	Gamo-Ningi
gan	Gan
gnq	Gana
gne	Ganang
gzn	Gane
gcd	Ganggalida
ggl	Ganglau
gnb	Gangte
gnl	Gangulu
gao	Gants
gza	Ganza
gnz	Ganzi
gga	Gao
pwg	Gapapaiwa
wrk	Garawa
gbm	Garhwali
cab	Garifuna
xgi	Garingbal
grt	Garo
gex	Garre
gyb	Garus
xgr	Garza
gaq	Gata'
cel-gau	Gaulish
gou	Gavar
gvo	Gavi?o Do Jiparan?
gwt	Gawar-Bati
gwd	Gawwada
gyl	Gayil
gay	Gayo
gzi	Gazi
gbr	Gbagyi
ggu	Gban
gbv	Gbanu
gbg	Gbanziri
gby	Gbari
gti	Gbati-ri
gba	Gbaya
gbp	Gbaya-Bossangoa
gbq	Gbaya-Bozoum
gmm	Gbaya-Mbodomo
gyg	Gbayi
gbs	Gbesi Gbe
ggb	Gbii
xgb	Gbin
grh	Gbiri-Niragu
gec	Gboloo Grebo
gwj	Gcwi
hmj	Ge
gez	Ge'ez
kvq	Geba Karen
gei	Gebe
gdd	Gedaged
drs	Gedeo
gji	Geji
ghk	Geko Karen
nlg	Gela
gio	Gelao
sbc	Gele'
geq	Geme
gej	Gen
gaf	Gende
geg	Gengle
ka	Georgian
ygp	Gepo
gew	Gera
gek	Gerka
de	German
nds-de	German Low German
gsg	German Sign Language
gea	Geruma
ges	Geser-Gorom
guv	Gey
gha	Ghadames
gse	Ghanaian Sign Language
gds	Ghandruk Sign Language
ghn	Ghanongga
gri	Ghari
bmk	Ghayavi
aln	Gheg Albanian
ghr	Ghera
bbj	Ghom?l?'
gho	Ghomara
aaa	Ghotuo
ghl	Ghulfan
bgi	Giangan
gib	Gibanawa
gid	Gidar
acd	Gikyode
glk	Gilaki
gil	Gilbertese
gix	Gilima
kmp	Gimme
gmn	Gimnime
gnm	Ginuman
ayg	Ginyanga
bbr	Girawa
nyf	Giryama
gih	Githabul
toh	Gitonga
ggt	Gitua
git	Gitxsan
giy	Giyug
tof	Gizrra
glr	Glaro-Twabo
glw	Glavda
oub	Glio-Oubi
igs	Glosa
gnu	Gnau
art-gld	Goa'uld
gig	Goaria
goi	Gobasi
gox	Gobu
god	Godi?
gdo	Godoberi
gdx	Godwari
ank	Goemai
gof	Gofa
gog	Gogo
ggw	Gogodala
zkg	Goguryeo
gju	Gojri
gkn	Gokana
gol	Gola
gvf	Golin
lja	Golpa
gon	Gondi
goo	Gone Dau
goe	Gongduk
gjn	Gonja
gni	Gooniyandi
gqr	Gor
goc	Gorakor
goq	Gorap
xgg	Goreng
gor	Gorontalo
grq	Gorovu
gow	Gorowa
got	Gothic
goy	Goundo
gux	Gourmanch?ma
goj	Gowlan
gok	Gowli
gwf	Gowro
goz	Gozarkhani
nli	Grangali
kbk	Grass Koiari
grb	Grebo
el	Greek
gss	Greek Sign Language
giq	Green Gelao
hnj	Green Hmong
kl	Greenlandic
crp-gep	Greenlandic Eskimo Pidgin
gcl	Grenadian Creole English
grs	Gresi
gro	Groma
ats	Gros Ventre
gwx	Gua
guh	Guahibo
gvj	Guaj?
gub	Guajaj?ra
gum	Guambiano
gvc	Guanano
gnc	Guanche
jiq	Guanyinqiao
gn	Guaran?
gyr	Guarayu
gsm	Guatemalan Sign Language
gta	Guat?
guo	Guayabero
xgd	Gudang
nji	Gudanji
gde	Gude
gdu	Gudu
gdf	Guduf-Gava
roa-grn	Guern?siais
ngu	Guerrero Nahuatl
zpg	Guevea De Humboldt Zapotec
ggd	Gugadj
gdc	Gugu Badhun
wrw	Gugu Warra
ghs	Guhu-Samane
gcr	Guianese Creole
zgb	Guibei Zhuang
bet	Guiberoua B?te
zgn	Guibian Zhuang
gkp	Guinea Kpelle
gus	Guinean Sign Language
gqi	Guiqiong
gu	Gujarati
glu	Gula
gmb	Gula'alaa
gvl	Gulay
gly	Gule
afb	Gulf Arabic
gli	Guliguli
gul	Gullah
gmu	Gumalu
gnn	Gumatj
gvs	Gumawana
guk	Gumuz
guw	Gun
gdi	Gundi
gjm	Gunditjmara
xrd	Gundungurra
gyf	Gungabula
rub	Gungu
gnt	Guntai
yas	Gunu
gup	Gunwinggu
gyy	Gunya
gpa	Gupa-Abawa
guf	Gupapuyngu
las	Gur Lama
gge	Guragone
grz	Guramalum
hac	Gurani
gnr	Gureng Gureng
ggg	Gurgula
grx	Guriaso
gue	Gurindji
gvm	Gurmana
goa	Guro
grd	Guruntum
gsn	Gusan
guz	Gusii
gsl	Gusilay
gmq-gut	Gutnish
kky	Guugu Yimidhirr
xgw	Guwa
gwu	Guwamu
gka	Guya
gyn	Guyanese Creole English
gvy	Guyani
ngs	Gvoko
gwb	Gwa
dah	Gwahatike
bga	Gwamhi-Wuri
gwn	Gwandara
grw	Gweda
gwe	Gweno
gwr	Gwere
gwi	Gwich'in
gyi	Gyele
gye	Gyem
haq	Ha
hbu	Habu
hdy	Hadiyya
hoj	Hadothi
xhd	Hadrami
ayh	Hadrami Arabic
hts	Hadza
aek	Haeke
hah	Hahon
hai	Haida
hgw	Haigwai
bzx	Hainyaxo Bozo
haf	Haiphong Sign Language
has	Haisla
ht	Haitian Creole
hvc	Haitian Vodoun Culture Language
hgm	Hai?om
hji	Haji
haj	Hajong
hak	Hakka
hao	Hak?
hal	Halang
hld	Halang Doan
hlb	Halbi
hla	Halia
hur	Halkomelem
hmu	Hamap
hba	Hamba
amf	Hamer-Banna
hmt	Hamtai
haa	Han
hag	Hanga
wos	Hanga Hundi
han	Hangaza
hni	Hani
lml	Hano
hab	Hanoi Sign Language
hnn	Hanunoo
xha	Harami
har	Harari
kjo	Harijan Kinnauri
hro	Haroi
hss	Harsusi
tmd	Haruai
hrk	Haruku
bgc	Haryanvi
hrz	Harzani
ybj	Hasha
mey	Hassaniya
had	Hatam
xht	Hattic
ha	Hausa
hsl	Hausa Sign Language
yuf	Havasupai-Walapai-Yavapai
hvk	Haveke
hav	Havu
hps	Hawai'i Pidgin Sign Language
haw	Hawaiian
hay	Haya
haz	Hazaragi
xed	Hdi
he	Hebrew
heh	Hehe
hbn	Heiban
hei	Heiltsuk
scp	Helambu Sherpa
heg	Helong
nix	Hema
hem	Hemba
hed	Herd?
hz	Herero
llf	Hermit
xhr	Hernican
hrt	H?rtevin
ham	Hewa
auk	Heyo
hib	Hibito
hid	Hidatsa
mba	Higaonon
kjk	Highland Konjo
chd	Highland Oaxaca Chontal
poi	Highland Popoluca
azz	Highland Puebla Nahuatl
tos	Highland Totonac
acw	Hijazi Arabic
hij	Hijuk
hil	Hiligaynon
mrr	Hill Maria
hir	Himarim?
hi	Hindi
dgo	Hindi Dogri
hii	Hinduri
gin	Hinukh
ho	Hiri Motu
hit	Hittite
htu	Hitu
hiw	Hiw
hix	Hixkaryana
lic	Hlai
yhl	Hlepho Phowa
hle	Hlersu
hmr	Hmar
hmv	Hmong D?
hmf	Hmong Don
hmz	Hmong Shua
mrk	Hmwaveke
hoc	Ho
hos	Ho Chi Minh City Sign Language
hoa	Hoava
hoh	Hoby?t
hhi	Hoia Hoia
hoi	Holikachuk
hoy	Holiya
hod	Holma
hoo	Holoholo
hol	Holu
hom	Homa
len	Honduran Lenca
hds	Honduras Sign Language
juh	H?ne
hks	Hong Kong Sign Language
how	Honi
hop	Hopi
hrm	Horned Miao
hor	Horo
hoe	Horom
ero	Horpa
hot	Hote
hti	Hoti
hov	Hovongan
hhy	Hoyahoya
hoz	Hozo
hpo	Hpon
hra	Hrangkhol
hre	Hre
hru	Hruso
huo	Hu
hug	Huachipaeri
hub	Huambisa
auc	Huaorani
var	Huarijio
hud	Huaulu
mau	Huautla Mazatec
huv	Huave
nhq	Huaxcaleca Nahuatl
hbb	Huba
tee	Huehuetla Tepehua
hch	Huichol
huh	Huilliche
mxs	Huitepec Mixtec
czh	Huizhou
huw	Hukumina
hul	Hula
huy	Hulaul?
hui	Huli
huk	Hulung
hmb	Humburi Senni Songhay
huf	Humene
hut	Humla
hke	Hunde
hnu	Hung
hum	Hungana
hu	Hungarian
hsh	Hungarian Sign Language
nat	Hungworo
hkk	Hunjara-Kaina Ke
xhc	Hunnic
hrx	Hunsrik
huz	Hunzib
hup	Hupa
jup	Hupd?
hap	Hupla
xhu	Hurrian
geh	Hutterisch
hwo	Hwana
hya	Hya
jab	Hyam
iwk	I-Wak
iai	Iaai
yml	Iamalele
iap	Iapama
ian	Iatmul
tmu	Iau
tek	Ibali Teke
ibl	Ibaloi
iba	Iban
ibg	Ibanag
iby	Ibani
ivb	Ibatan
xib	Iberian
ibb	Ibibio
ibn	Ibino
bkp	Iboko
ibu	Ibu
ibr	Ibuoro
is	Icelandic
icl	Icelandic Sign Language
bec	Iceve-Maci
dbj	Ida'an
ida	Idakho-Isukha-Tiriki
idt	Idat?
ide	Idere
ids	Idesa
idi	Idi
io	Ido
idu	Idoma
idc	Idon
clk	Idu-Mishmi
ldb	Idun
viv	Iduna
ife	If?
iff	Ifo
igl	Igala
igg	Igana
ig	Igbo
ige	Igede
ign	Ignaciano
ahl	Igo
nar	Iguta
igw	Igwe
ihp	Iha
ihb	Iha Based Pidgin
ihi	Ihievbe
vki	Ija-Zuba
ikx	Ik
ikk	Ika
ikr	Ikaranggal
ikz	Ikizu
iki	Iko
meb	Ikobi-Mena
ntk	Ikoma
koq	Ikota
txi	Ikpeng
ikp	Ikpeshi
kpo	Ikposo
ikv	Iku-Gora-Ankwa
ikl	Ikulu
ikw	Ikwere
iqw	Ikwo
ilb	Ila
ila	Ile Ape
ilg	Ilgar
ili	Ili Turki
ilu	Ili'uun
mbi	Ilianen Manobo
xil	Illyrian
ilo	Ilocano
ilk	Ilongot
ilv	Ilue
mlk	Ilwana
imo	Imbongu
ime	Imeraguen
imn	Imonda
imr	Imroing
abx	Inabaknon
mzu	Inapang
inp	I?apari
smn	Inari Sami
ins	Indian Sign Language
idb	Indo-Portuguese
id	Indonesian
bdl	Indonesian Bajau
inl	Indonesian Sign Language
idr	Indri
mvy	Indus Kohistani
xiv	Indus Valley Language
oin	Inebu One
inz	Inese?o
inb	Inga
izh	Ingrian
inh	Ingush
iti	Inlaod Itneg
ino	Inoke-Yate
loc	Inonhan
ior	Inor
nkf	Inpui Naga
ia	Interlingua
ie	Interlingue
ils	International Sign
int	Intha
iu	Inuktitut
ik	Inupiak
azm	Ipalapa Amuzgo
ipo	Ipiko
ipi	Ipili
ass	Ipulo
iqu	Iquito
irr	Ir
irn	Ir?ntxe
ill	Iranun
acm	Iraqi Arabic
irk	Iraqw
irh	Irarutu
iry	Iraya
ire	Iresim
bto	Iriga Bicolano
iri	Irigwe
ga	Irish
isg	Irish Sign Language
iru	Irula
isa	Isabi
tts	Isan
isn	Isanzu
agk	Isarog Agta
isc	Isconahua
igo	Isebe
its	Isekiri
isk	Ishkashimi
inn	Isinai
srl	Isirawa
crb	Island Carib
icr	Islander Creole English
isd	Isnag
iso	Isoko
isr	Israeli Sign Language
mir	Isthmus Mixe
zai	Isthmus Zapotec
nhk	Isthmus-Cosoleacaque Nahuatl
nhx	Isthmus-Mecayapan Nahuatl
nhp	Isthmus-Pajapan Nahuatl
ist	Istriot
ruo	Istro-Romanian
isu	Isu
szv	Isubu
it	Italian
ise	Italian Sign Language
itv	Itawit
itl	Itelmen
ite	Itene
itr	Iteri
itx	Itik
itw	Ito
ito	Itonama
itm	Itu Mbon Uzo
mce	Itundujia Mixtec
itz	Itz?
ium	Iu Mien
ivv	Ivatan
ibd	Iwaidja
kbm	Iwal
iwm	Iwam
iwo	Iwur
ixc	Ixcatec
mzi	Ixcatl?n Mazatec
ixl	Ixil
vmj	Ixtayutla Mixtec
otz	Ixtenco Otomi
iya	Iyayu
uiv	Iyive
nca	Iyo
crq	Iyo'wujwa Chorote
crt	Iyojwa'ja Chorote
izr	Izere
izz	Izi
izi	Izi-Ezaa-Ikwo-Mgbo
ijc	Izon
cbo	Izora
jae	Jabem
jbt	Jabut?
jda	Jad
jdg	Jadgali
jah	Jah Hut
jad	Jahanka
awv	Jair Awyu
jac	Jakaltek
jat	Jakati
jak	Jakun
maj	Jalapa De D?az Mazatec
bxl	Jalkunan
jcs	Jamaican Country Sign Language
jam	Jamaican Creole
jls	Jamaican Sign Language
jaa	Jamamad?
jax	Jambi Malay
mxt	Jamiltepec Mixtec
djm	Jamsay Dogon
jnd	Jandavra
djo	Jangkang
jna	Jangshung
jni	Janji
ja	Japanese
jsl	Japanese Sign Language
jru	Japrer?a
jqr	Jaqaru
jaf	Jara
jra	Jarai
anq	Jarawa
ddj	Jaru
jns	Jaunsari
jv	Javanese
jvd	Javindo
jaz	Jawe
jyy	Jaya
jeb	Jebero
jeh	Jeh
jhi	Jehai
qfa-kor-jjm	Jeju
tow	Jemez
bze	Jenaama Bozo
jeg	Jeng
xuj	Jennu Kurumba
jer	Jere
jek	Jeri Kuo
roa-jer	J?rriais
gmw-jdt	Jersey Dutch
akj	Jeru
jee	Jerung
jhs	Jhankot Sign Language
jio	Jiamao
jya	Jiarong
juo	Jiba
jib	Jibu
apj	Jicarilla
jii	Jiiddu
jie	Jilbe
jil	Jilim
jmi	Jimi
jim	Jimjimen
cjy	Jin
jia	Jina
kac	Jingpho
jig	Jingulu
pnu	Jiongnai Bunu
jul	Jirel
jrr	Jiru
jit	Jita
kaj	Jju
job	Joba
jbr	Jofotek-Bromnya
dyo	Jola-Fonyi
csk	Jola-Kasa
jeu	Jonkor Bourmataguil
jor	Jor?
jos	Jordanian Sign Language
jrt	Jorto
jow	Jowulu
juu	Ju
jun	Juang
pga	Juba Arabic
jrb	Judeo-Arabic
jbe	Judeo-Berber
jge	Judeo-Georgian
yhd	Judeo-Iraqi Arabic
itk	Judeo-Italian
aju	Judeo-Moroccan Arabic
jpr	Judeo-Persian
jdt	Judeo-Tat
yud	Judeo-Tripolitanian Arabic
ajt	Judeo-Tunisian Arabic
jye	Judeo-Yemeni Arabic
jbu	Jukun Takum
jua	J?ma
jum	Jumjum
jus	Jumla Sign Language
jml	Jumli
inj	Jungle Inga
mxq	Juquila Mixe
bex	Jur Modo
juy	Juray
juc	Jurchen
jur	Jur?na
jut	Jutish
mwb	Juwal
vmc	Juxtlahuaca Mixtec
ktz	Ju?'hoan
jwi	Jwira-Pepesa
quc	K'iche'
xku	Kaamba
ldl	Kaan
ckn	Kaang Chin
gna	Kaansa
uks	Kaapor Sign Language
ksp	Kaba
kvf	Kabalai
kbd	Kabardian
xkp	Kabatei
lap	Kabba-Laka
xbx	Kabix?
kbp	Kabiy?
klz	Kabola
onk	Kabore One
lkb	Kabras
uka	Kaburi
kbu	Kabutra
kea	Kabuverdianu
cwa	Kabwa
kcw	Kabwari
kab	Kabyle
kcx	Kachama-Ganjule
xac	Kachari
kfr	Kachchi
gjk	Kachi Koli
koe	Kacipo-Balesi
xkk	Kaco'
kzd	Kadai
kej	Kadar
kad	Kadara
kdu	Kadaru
kbc	Kadiw?u
kdv	Kado
xtc	Kadugli
ktp	Kaduo
kbr	Kafa
kpu	Kafoa
kll	Kagan Kalagan
syw	Kagate
cgc	Kagayanen
kdm	Kagoma
xkg	Kagoro
kki	Kagulu
hka	Kahe
agw	Kahua
kct	Kaian
kzb	Kaibobo
kzp	Kaidipang
kbw	Kaiep
kep	Kaikadi
kzq	Kaike
kkq	Kaiku
xai	Kaimb?
zka	Kaimbulawa
kgp	Kaingang
ckr	Kairak
kxa	Kairiru
krd	Kairui-Midiki
kzm	Kais
kce	Kaivi
kgk	Kaiw?
tcq	Kaiy
ckq	Kajakse
xkj	Kajali
kag	Kajaman
kqf	Kakabai
kke	Kakabe
kka	Kakanda
kbf	Kakauhua
tbd	Kaki Ae
kxe	Kakihum
kkj	Kako
keo	Kakwa
kcl	Kala
mwp	Kala Lagaw Ya
lkm	Kalaamaya
kve	Kalabakan
ijn	Kalabari
kzz	Kalabra
kqe	Kalagan
kkf	Kalaktang Monpa
kmh	Kalam
gwc	Kalami
knz	Kalams?
wkl	Kalanadi
kck	Kalanga
kly	Kalao
kyl	Kalapuya
kba	Kalarko
kls	Kalasha
kln	Kalenjin
ktg	Kalkatungu
xka	Kalkoti
xal	Kalmyk
rmf	Kalo Finnish Romani
ywa	Kalou
bco	Kaluli
kli	Kalumpang
kdx	Kam
vkm	Kamakan
woi	Kamang
kbq	Kamano
kci	Kamantan
keq	Kamar
jmr	Kamara
kzx	Kamarian
kgx	Kamaru
klp	Kamasa
kms	Kamasau
xas	Kamassian
kyk	Kamayo
kay	Kamayur?
kam	Kamba
ktb	Kambaata
kyy	Kambaira
xbr	Kambera
kbv	Kamberataro
irx	Kamberau
xbw	Kambiw?
kmi	Kami
kcq	Kamo
kgq	Kamoro
rkt	Kamta
xmu	Kamu
xla	Kamula
xvi	Kamviri
hig	Kamwe
xnb	Kanakanabu
kna	Kanakuru
knm	Kanamari
xns	Kanashi
soq	Kanasi
bjj	Kanauji
kqw	Kandas
gam	Kandawo
kbs	Kande
kyp	Kang
kcp	Kanga
kkv	Kangean
igm	Kanggape
kxs	Kangjia
kty	Kango
kzy	Kango-Sua
xnr	Kangri
ktk	Kaniet
kev	Kanikkaran
kdp	Kaningdon-Nindem
kzo	Kaningi
knr	Kaningra
wat	Kaninuwa
kmu	Kanite
kft	Kanjari
kbe	Kanju
kne	Kankanaey
kn	Kannada
kfi	Kannada Kurumba
kxo	Kano?
kxn	Kanowit-Tanjong Melanau
ksk	Kansa
xkt	Kantosi
khx	Kanu
kni	Kanufi
kr	Kanuri
kny	Kanyok
kax	Kao
kqn	Kaonde
ykm	Kap
pam	Kapampangan
khp	Kapauri
tbx	Kapin
xpn	Kapinaw?
kpg	Kapingamarangi
dju	Kapriman
kbi	Kaptiau
klo	Kapya
leu	Kara (New Guinea)
reg	Kara (Tanzania)
krc	Karachay-Balkar
gbd	Karadjeri
mry	Karaga Mandaya
xkh	Karahawyana
kdr	Karaim
kpj	Karaj?
kaa	Karakalpak
xqa	Karakhanid
xar	Karami
kdj	Karamojong
kzr	Karang
kth	Karanga
zkk	Karankawa
kyj	Karao
kgv	Karas
kpt	Karata
xrw	Karawa
mjw	Karbi
kai	Karekare
krl	Karelian
kyd	Karey
kbj	Kari
kgn	Karingani
kuq	Karipuna
kgm	Karip?na
kmv	Karip?na Creole French
kzw	Karir?-Xoc?
ktn	Kariti?na
kil	Kariya
vka	Kariyarra
yuj	Karkar-Yuri
krb	Karkin
kko	Karko
bbv	Karnai
kxh	Karo
btx	Karo Batak
kyh	Karok
kyn	Karolanos
krx	Karon
kgw	Karon Dori
xkx	Karore
xrq	Karranga
rxw	Karuwali
ccj	Kasanga
xsm	Kasem
kju	Kashaya
ks	Kashmiri
csb	Kashubian
ksn	Kasiguranin
kkz	Kaska
zsk	Kaskean
gva	Kaskih?
kgc	Kasseng
kao	Kassonke
khs	Kasua
kgd	Kataang
ktq	Katabaga
xat	Katawixi
kmg	K?te
tkt	Kathoriya Tharu
ykt	Kathu
bsh	Kati
kfu	Katkari
kcr	Katla
ktw	Kato
kaf	Katso
kta	Katua
kav	Katuk?na
pss	Kaulong
vkk	Kaur
bpp	Kaure
zku	Kaurna
xau	Kauwera
ckv	Kavalan
krv	Kavet
kcb	Kawacha
xaw	Kawaiisu
kgb	Kawe
alc	Kaw?sqar
ktx	Kaxarar?
kbb	Kaxui?na
zra	Kaya
kyz	Kayab?
kyt	Kayagar
pdu	Kayan
xay	Kayan Mahakam
xkn	Kayan River Kayan
kak	Kayapa Kallahan
txu	Kayap?
gyd	Kayardild
kzl	Kayeli
kxy	Kayong
kyv	Kayort
gbb	Kaytetye
kzu	Kayupulau
kk	Kazakh
kzk	Kazukuru
xxk	Ke'o
keh	Keak
khz	Keapara
meo	Kedah Malay
ksx	Kedang
kdy	Keder
khh	Kehu
kei	Kei
kec	Keiga
bmh	Kein
eyo	Keiyo
kel	Kela
kzi	Kelabit
keb	K?l?
ify	Keley-I Kallahan
kbo	Keliko
xel	Kelo
kyo	Kelon
kem	Kemak
xem	Kembayan
bzp	Kemberano
xkw	Kembra
dmo	Kemezung
sjk	Kemi Sami
kfj	Kemiehua
kmt	Kemtuik
xbn	Kenaboi
gat	Kenati
knx	Kendayan
klf	Kendeje
kvm	Kendem
kyq	Kenga
kxi	Keningau Murut
knl	Keninjal
kns	Kensiu
ndb	Kenswei Nsei
xki	Kenyan Sign Language
ken	Kenyang
lke	Kenyi
xeu	Keoru-Ahia
kpn	Kepkiriw?t
kuk	Kepo'
ker	Kera
hhr	Kerak
xke	Kereho
krk	Kerek
ked	Kerewe
kxz	Kerewo
kvr	Kerinci
xes	Kesawai
ket	Ket
kae	Ketangalan
kcv	Kete
xte	Ketengban
ktt	Ketum
kyg	Keyagana
xkv	Kgalagadi
kjh	Khakas
kjf	Khalaj
klr	Khaling
kjl	Kham
kbg	Khamba
khg	Khams Tibetan
kht	Khamti
ksu	Khamyang
ogo	Khana
khn	Khandesi
kjm	Kh?ng
kca	Khanty
xao	Khao
kfw	Kharam Naga
khr	Kharia
ksy	Kharia Thar
kha	Khasi
lko	Khayo
zkz	Khazar
kqg	Khe
tlx	Khehek
xkf	Khengkha
xhe	Khetrani
nkh	Khezha Naga
kix	Khiamniungan Naga
kjj	Khinalug
kwx	Khirwar
kqm	Khisa
zkt	Khitan
llo	Khlor
ykl	Khlula
km	Khmer
kjg	Khmu
xkc	Kho'ini
nkb	Khoibu Naga
ktc	Kholok
kxc	Khonso
kmz	Khorasani Turkish
zkh	Khorezmian
kho	Khotanese
khw	Khowar
xhv	Khua
khf	Khuen
cnk	Khumi Chin
kkh	Kh?n
kfm	Khunsari
khv	Khvarshi
bez	Kibena
kie	Kibet
prm	Kibiri
kic	Kickapoo
kzg	Kikai
kcu	Kikami
kmw	Kikumu
ki	Kikuyu
sjd	Kildin Sami
kij	Kilivila
klb	Kiliwa
kih	Kilmeri
kia	Kim
mji	Kim Mun
kig	Kimaama
kqr	Kimaragang
kiv	Kimbu
kmb	Kimbundu
sbt	Kimki
kqp	Kimr?
cbw	Kinabalian
kco	Kinalakna
krj	Kinaray-a
zga	Kinga
gqn	Kinikinao
kfk	Kinnauri
knq	Kintaq
kkd	Kinuku
bmy	Kinyabemba
rw	Kinyarwanda
ues	Kioko
kkm	Kiong
xko	Kiorr
kio	Kiowa
pkb	Kipfokomo
sgc	Kipsigis
kyi	Kiput
kkr	Kir-Balar
geb	Kire
kks	Kirfi
okr	Kirike
kiy	Kirikiri
rn	Kirundi
fkk	Kirya-Konzel
kis	Kis
lks	Kisa
xis	Kisan
kqh	Kisankasa
kje	Kisar
kiz	Kisi
gru	Kistane
mwk	Kita Maninkakan
tbt	Kitembo
gia	Kitja
kii	Kitsai
ktu	Kituba
wei	Kiunum
yaf	Kiyaka
lda	Kla
clm	Klallam
kla	Klamath-Modoc
klu	Klao
kqt	Klias River Kadazan
tlh	Klingon
czk	Knaanic
fuj	Ko
kib	Koalib
cku	Koasati
kpd	Koba
kcj	Kobiana
kgu	Kobol
kpw	Kobon
kdq	Koch
thq	Kochila Tharu
cdz	Koda
ksz	Kodaku
kfa	Kodava
vko	Kodeoha
kod	Kodi
kwp	Kodia
kcs	Koenoem
kso	Kofa
kpi	Kofei
kwl	Kofyar
kkx	Kohin
plk	Kohistani Shina
kpm	Koho
bcs	Kohumono
kkt	Koi
zkb	Koibal
nkd	Koireng
kqi	Koitabu
kxt	Koiwat
gko	Kok-Nar
okg	Kok-Paponk
ktd	Kokata
trp	Kokborok
kou	Koke
kkp	Koko-Bera
xod	Kokoda
kzn	Kokola
kkk	Kokota
biw	Kol (Cameroon)
kvv	Kola
klc	Kolbila
ekl	Kolhe
skn	Kolibugan Subanon
klm	Kolom
ksh	K?lsch
klx	Koluwawa
bkm	Kom (Cameroon)
kmm	Kom (India)
kmy	Koma
kpf	Komba
tyn	Kombai
xbi	Kombio
kge	Komering
koi	Komi-Permyak
kpv	Komi-Zyrian
xoi	Kominimung
xom	Komo
kvh	Komodo
kvp	Kompane
kzv	Komyandaret
kkn	Kon Keu
bbo	Konab?r?
kxw	Konai
knd	Konda
kfc	Konda-Dora
kdw	Koneraw
kg	Kongo
kok	Konkani
xon	Konkomba
kma	Konni
knu	Kono (Guinea)
klk	Kono (Nigeria)
kno	Kono (Sierra Leone)
koa	Konomala
kcz	Konongo
nbe	Konyak Naga
mku	Konyanka Maninka
koo	Konzo
ozm	Koonzime
kqy	Koorete
xop	Kopar
opk	Kopkaka
kpr	Korafe-Yegha
koz	Korak
kqz	Korana
kcy	Korandje
ko	Korean
kvk	Korean Sign Language
coe	Koreguaje
okh	Koresh-e Rostam
kfq	Korku
vkp	Korlai Creole Portuguese
jkr	Koro (India)
kxr	Koro (New Guinea)
krf	Koro (Vanuatu)
kfo	Koro (West Africa)
kfz	Koromf?
kqj	Koromira
bpr	Koronadal Blaan
xkq	Koroni
krp	Korop
xxr	Korop?
ktl	Koroshi
khe	Korowai
kfd	Korra Koraga
xor	Korubo
kpq	Korupun-Sela
kfp	Korwa
kpy	Koryak
kiq	Kosadle
kkl	Kosarek Yale
kze	Kosena
kid	Koshin
kos	Kosraean
kfe	Kota
mqg	Kota Bangun Kutai Malay
grm	Kota Marudu Talantang
ktr	Kota Marudu Tinagas
kqk	Kotafon Gbe
avk	Kotava
eko	Koti
zko	Kott
kyf	Kouya
kqb	Kovai
kvc	Kove
xow	Kowaki
kwh	Kowiai
kqd	Koy Sanjaq Surat
kff	Koya
kga	Koyaga
koh	Koyo
khq	Koyra Chiini Songhay
ses	Koyraboro Senni Songhai
koy	Koyukon
kuw	Kpagua
kpl	Kpala
kpk	Kpan
pbn	Kpasam
koc	Kpati
kym	Kpatili
cpo	Kpeego
kpe	Kpelle
kef	Kpessi
kph	Kplang
kye	Krache
xra	Krah?
rka	Kraol
kqq	Krenak
krs	Kresh
zkv	Krevinian
xre	Kreye
xri	Krikati-Timbira
krm	Krim
kri	Krio
rop	Kriol
ksi	Krisa
cpp	Kristang
kxb	Krobu
kgo	Krongo
krr	Kru'ng
jct	Krymchak
kry	Kryts
tyu	Kua
uan	Kuan
xnh	Kuanhua
kgf	Kube
kof	Kubi
jko	Kubo
kvb	Kubu
lkc	Kucong
kfg	Kudiya
kyw	Kudmali
kov	Kudu-Camo
kow	Kugama
kes	Kugbo
xmh	Kugu-Muminh
kxu	Kui (India)
kvd	Kui (Indonesia)
dkr	Kuijau
kui	Kuik?ro
vkj	Kujarge
kfn	Kuk
kux	Kukatja
kez	Kukele
kex	Kukna
xmq	Kuku-Mangk
xmp	Kuku-Mu'inh
ugb	Kuku-Ugbanh
uwa	Kuku-Uwanh
gvn	Kuku-Yalanji
tpg	Kula
glj	Kulaal
kul	Kulere
kxj	Kulfa
xpk	Kulina
vkl	Kulisusu
kfx	Kullu Pahari
uun	Kulon-Pazeh
kle	Kulung
nee	Kumak
ksl	Kumalu
kdi	Kumam
kue	Kuman
kfy	Kumaoni
kmj	Kumarbhag Paharia
ksm	Kumba
kgs	Kumbainggar
wkb	Kumbaran
xks	Kumbewaha
kra	Kumhali
dih	Kumiai
kuo	Kumukio
kum	Kumyk
zum	Kumzari
cuk	Kuna
kun	Kunama
wlg	Kunbarlang
kdn	Kunda
shd	Kundal Shahi
wku	Kunduvadi
kfl	Kung
ggk	Kungarakany
gdt	Kungardutyi
kvs	Kunggara
kgl	Kunggari
lku	Kungkari
kse	Kuni
kvg	Kuni-Boazi
xug	Kunigami
kup	Kunimaipa
pep	Kunja
kjn	Kunjen
njx	Kunyi
kuz	Kunza
xuo	Kuo
kto	Kuot
kug	Kupa
mkn	Kupang Malay
key	Kupia
kpz	Kupsabiny
kuv	Kur
nqk	Kura Ede Nago
krh	Kurama
knk	Kuranko
ku	Kurdish
nbn	Kuri
kuj	Kuria
kfh	Kurichiya
kfv	Kurmukar
unn	Kurnai
vku	Kurrama
ktm	Kurti
gdj	Kurtjar
xkz	Kurtop
kyr	Kuru?ya
kjr	Kurudu
kru	Kurukh
kus	Kusaal
ksg	Kusaghe
kuh	Kushi
ksv	Kusu
kgg	Kusunda
ght	Kutang Ghale
kut	Kutenai
kub	Kutep
xut	Kuthant
kpa	Kutto
kdc	Kutu
khj	Kuturmi
thd	Kuuk Thaayorre
uky	Kuuk Yak
kuy	Kuuku-Ya'u
kxv	Kuvi
blh	Kuwaa
cwt	Kuwaataay
kdt	Kuy
fkv	Kven
wka	Kw'adza
bko	Kwa'
ksq	Kwaami
kwz	Kwadi
kwd	Kwaio
kdz	Kwaja
kwq	Kwak
kwk	Kwak'wala
kwu	Kwakum
qwt	Kwalhioqua-Tlatskanai
kmq	Kwama
kwm	Kwambi
tnk	Kwamera
ktf	Kwami
okk	Kwamtim One
kvi	Kwang
kwj	Kwanga
kwn	Kwangali
knp	Kwanja
kj	Kwanyama
kwf	Kwara'ae
nmg	Kwasio
kya	Kwaya
xwa	Kwaza
xwg	Kwegu
kwr	Kwer
kwe	Kwerba
xwr	Kwerba Mamberamo
cwe	Kwere
kkb	Kwerisa
kws	Kwese
kwt	Kwesten
gww	Kwini
kuc	Kwinsu
kww	Kwinti
kmo	Kwoma
kwo	Kwomtari
xuu	Kxoe
bka	Kyak
kyc	Kyaka
nqq	Kyan-Karyaw Naga
kql	Kyenele
tye	Kyenga
kgy	Kyerung
ky	Kyrgyz
lbi	La'bi
bwj	L?? L?? Bwamu
ldn	L?adan
gdm	Laal
cae	Laalaa
lau	Laba
lbb	Label
jku	Labir
mwi	Labo
ypb	Labo Phowa
lbu	Labu
dtb	Labuk-Kinabatangan Kadazan
lac	Lacandon
lbt	Lachi
zpa	Lachiguiri Zapotec
zpl	Lachix?o Zapotec
lbj	Ladakhi
lld	Ladin
lad	Ladino
llj	Ladji-Ladji
lkl	Laeko-Libuat
laf	Lafofa
lgb	Laghu
lgh	Laghuu
kot	Lagwan
lhh	Laha (Indonesia)
lha	Laha (Vietnam)
lhn	Lahanan
lah	Lahnda
kvt	Lahta Karen
lhu	Lahu
lhi	Lahu Shi
lhl	Lahul Lohar
cnh	Lai
lmx	Laimbue
clj	Laitu Chin
lji	Laiyolo
lbe	Lak
lak	Laka
lka	Lakalei
lmw	Lake Miwok
lkh	Lakha
lki	Laki
lbc	Lakkia
lkn	Lakon
lkd	Lakond?
lkt	Lakota
dic	Lakota Dida
nrz	Lala
leb	Lala-Bisa
lla	Lala-Roba
cnl	Lalana Chinantec
lal	Lalia
lay	Lama Bai
slp	Lamaholot
lmr	Lamalera
hia	Lamang
lmq	Lamatuka
lam	Lamba
lmn	Lambadi
lmh	Lambichhong
lmy	Lamboya
lai	Lambya
bma	Lame
lmu	Lamenu
lbn	Lamet
ldh	Lamja-Dengsa-Tola
lmk	Lamkang
lev	Lamma
lns	Lamnso'
lmg	Lamogai
ljp	Lampung Api
llh	Lamu
lby	Lamu-Lamu
ruu	Lanas Lobu
ldm	Landoma
yne	Lang'e
lnm	Langam
lna	Langbashe
lag	Langi
yln	Langnian Buyang
lno	Lango (Sudan)
laj	Lango (Uganda)
lnw	Lanima
lnh	Lanoh
lo	Lao
nlq	Lao Naga
lwm	Laomian
lbg	Laopang
lso	Laos Sign Language
ztl	Lapagu?a-Guivini Zapotec
art-lap	Lapine
laa	Lapuyan Subanun
lrg	Laragia
lrt	Larantuka Malay
lbz	Lardil
lrv	Larevat
lrl	Lari
alo	Larike-Wakasihu
lro	Laro
lar	Larteh
lan	Laru
llm	Lasalimu
lsa	Lasgerdi
lsi	Lashi
lss	Lasi
ltg	Latgalian
la	Latin
ltu	Latu
ltn	Latund?
lv	Latvian
lsl	Latvian Sign Language
llu	Lau
luf	Laua
llx	Lauan
law	Lauje
lur	Laura
lre	Laurentian
clt	Lautu Chin
lbv	Lavatbura-Lamusong
brb	Lave
lbo	Laven
lvk	Lavukaleve
lbx	Lawangan
lwu	Lawu
tgi	Lawunuia
lya	Layakha
lzz	Laz
cle	Lealao Chinantec
lec	Leco
lew	Ledo Kaili
ldk	Leelau
lfa	Lefa
lgm	Lega-Mwenga
lea	Lega-Shabunda
agb	Legbo
lcc	Legenyem
tql	Lehali
urr	Lehalurup
lzn	Leinong Naga
lek	Leipon
llk	Lelak
lln	Lele (Chad)
llc	Lele (Guinea)
lle	Lele (New Guinea)
lef	Lelemi
lpa	Lelepa
leq	Lembena
lrz	Lemerig
lei	Lemio
xle	Lemnian
ley	Lemolang
ldj	Lemoro
tnl	Lenakel
led	Lendu
lgi	Lengilu
lgr	Lengo
lej	Lengola
leh	Lenje
ler	Lenkau
ldg	Lenyima
roa-leo	Leonese
lep	Lepcha
lpe	Lepki
xlp	Lepontic
gnh	Lere
les	Lese
let	Lesing-Gelimi
nms	Letemboi
leo	Leti (Cameroon)
lti	Leti (Indonesia)
lvu	Levuka
lww	Lewo
lwe	Lewo Eleng
lwt	Lewotobi
ayi	Leyigha
lez	Lezgi
mhx	Lhaovo
lhp	Lhokpu
lhm	Lhomi
ljl	Li'o
lix	Liabuku
ste	Liana-Seti
njn	Liangmai Naga
zln	Lianshan Zhuang
xpe	Liberia Kpelle
lir	Liberian English
liq	Libido
liz	Libinza
lbl	Libon Bikol
xli	Liburnian
ayl	Libyan Arabic
lbs	Libyan Sign Language
lig	Ligbi
lgz	Ligenza
lij	Ligurian
lih	Lihir
mgi	Lijili
lik	Lika
lio	Liki
lie	Likila
kxx	Likuba
lib	Likum
kwc	Likwala
lll	Lilau
lil	Lillooet
bme	Limassa
lif	Limbu
lmp	Limbum
li	Limburgish
ylm	Limi
lmc	Limilngan
kmk	Limos Kalinga
klw	Lindu
lab	Linear A
ln	Lingala
onb	Lingao
lgk	Lingarak
lii	Lingkhim
ngc	Lingombe
lfn	Lingua Franca Nova
lnj	Linngithigh
apl	Lipan
lpo	Lipo
lcs	Lisabata-Nuniali
lcl	Lisela
lsh	Lish
trg	Lish?n Did?n
lsd	Lishana Deni
aij	Lishanid Noshan
lis	Lisu
lzh	Literary Chinese
lt	Lithuanian
lls	Lithuanian Sign Language
lzl	Litzlitz
zlj	Liujiang Zhuang
zlq	Liuqian Zhuang
liv	Livonian
olo	Livvi
lht	Lo-Toga
lrk	Loarki
loq	Lobala
lob	Lobi
lbm	Lodhi
lgq	Logba
log	Logo
lof	Logol
rag	Logooli
liu	Logorik
src	Logudorese Sardinian
jbo	Lojban
yaz	Lokaa
lok	Loko
lky	Lokoya
lcd	Lola
llq	Lolak
llg	Lole
llb	Lolo
loa	Loloda
ycl	Lolopo
lmv	Lomaiviti
loi	Lomakka
rmi	Lomavren
lmo	Lombard
lng	Lombardic
lmi	Lombi
loo	Lombo
ngl	Lomwe
lce	Loncong
lpn	Long Phuri Naga
ttw	Long Wat
nxd	Longandu
lgu	Longgu
wok	Longto
lnu	Longuda
los	Loniu
crc	Lonwolwol
lnz	Lonzo
ldo	Loo
lom	Looma
lop	Lopa
lov	Lopi
lpx	Lopit
lrn	Lorang
lnn	Lorediakarkar
spq	Loreto-Ucayali Spanish
uvl	Lote
njh	Lotha Naga
dtr	Lotud
lot	Lotuko
loj	Lou
lou	Louisiana Creole French
lox	Loun
xlo	Loup A
xlb	Loup B
vnk	Lovono
nds	Low German
loy	Lowa
xbb	Lower Burdekin
cea	Lower Chehalis
dni	Lower Grand Valley Dani
dsb	Lower Sorbian
axl	Lower Southern Aranda
tto	Lower Ta'oih
taa	Lower Tanana
clo	Lowland Oaxaca Chontal
tac	Lowland Tarahumara
ztp	Loxicha Zapotec
loz	Lozi
khb	L?
prb	Lua'
lex	Luang
lu	Luba-Katanga
kcc	Lubila
lcf	Lubu
knb	Lubuagan Kalinga
lch	Luchazi
luq	Lucumi
lud	Ludian
ldq	Lufu
lg	Luganda
lgg	Lugbara
ruf	Luguru
lcq	Luhu
luy	Luhya
lba	Lui
lum	Luimbi
lui	Luise?o
dop	Lukpa
ule	Lule
smj	Lule Sami
luu	Lumba-Yakkha
lmz	Lumbee
lup	Lumbu
lmd	Lumun
lnd	Lun Bawang
luj	Luna
luk	Lunanakha
lun	Lunda
lga	Lungga
luo	Luo
hml	Luopohe Hmong
ldd	Luri
lse	Lusengo
lut	Lushootseed
khl	Lusi
xls	Lusitanian
lts	Lutachoni
ndy	Lutos
lue	Luvale
luv	Luwati
xlu	Luwian
lwo	Luwo
lb	Luxembourgish
lyn	Luyana
lwa	Lwalu
xlc	Lycian
xld	Lydian
lee	Ly?l?
lyg	Lyngngam
lsg	Lyons Sign Language
msj	Ma
mhy	Ma'anyan
mhi	Ma'di
slz	Ma'ya
cma	Maa
mew	Maaka
mdy	Maale
mas	Maasai
ymm	Maay
mqa	Maba
mmz	Mabaale
mfz	Mabaan
kkg	Mabaka Valley Kalinga
muj	Mabire
mca	Maca
mcl	Macaguaje
mbn	Macagu?n
mzs	Macanese
mk	Macedonian
jmc	Machame
mcb	Machiguenga
mpd	Machinere
mvw	Machinga
wpc	Maco
myy	Macuna
mbc	Macushi
mxu	Mada (Cameroon)
mda	Mada (Nigeria)
mzc	Madagascar Sign Language
mmx	Madak
xmx	Maden
grg	Madi
zml	Madngele
kmd	Madukayang Kalinga
mad	Madurese
mme	Mae
hmk	Maek
itt	Maeng Itneg
maf	Mafa
mkv	Mafea
sgb	Mag-Anchi Ayta
blx	Mag-Indi Ayta
mtw	Magahat
mag	Magahi
xtm	Magdalena Pe?asco Mixtec
gmd	M?ghd?
gmg	Mag?yi
gmx	Magoma
zgr	Magori
mdh	Maguindanao
mjx	Mahali
pmh	Maharastri Prakrit
bfz	Mahasu Pahari
mjy	Mahican
mhb	Mahongwe
mxx	Mahou
mcw	Mahwa
sks	Maia
mzz	Maiadomu
tnh	Maiani
mmm	Maii
mgu	Mailu
cwb	Maindo
zrs	Mairasi
mbq	Maisin
mai	Maithili
wmm	Maiwa (Indonesia)
mti	Maiwa (New Guinea)
mum	Maiwala
mpe	Majang
xmj	Majera
mjz	Majhi
mmj	Majhwar
mkg	Mak (China)
pbl	Mak (Nigeria)
mcp	Makaa
myh	Makah
mkz	Makasae
mak	Makasar
mfp	Makassar Malay
aup	Makayam
vmw	Makhuwa
xmc	Makhuwa-Marrevone
mgh	Makhuwa-Meetto
mhm	Makhuwa-Moniga
xsq	Makhuwa-Saka
vmk	Makhuwa-Shirima
mgf	Maklew
zmh	Makolkol
kde	Makonde
lva	Maku'a
mpu	Makur?p
jmn	Makuri Naga
ymk	Makwe
umn	Makyan Naga
mlf	Mal
mkb	Mal Paharia
ped	Mala (New Guinea)
ruy	Mala (Nigeria)
ima	Mala Malasar
ccm	Malaccan Creole Malay
mcm	Malaccan Creole Portuguese
mg	Malagasy
mmt	Malalamai
mln	Malango
mjo	Malankuravan
mjp	Malapandaram
mjq	Malaryan
mkr	Malas
mqz	Malasanga
ymr	Malasar
mjr	Malavedan
lon	Malawi Lomwe
swk	Malawi Sena
ms	Malay
ml	Malayalam
xdy	Malayic Dayak
mlz	Malaynon
mbp	Malayo
xml	Malaysian Sign Language
bfo	Malba Birifor
mdc	Male
pqm	Malecite-Passamaquoddy
gut	Mal?ku Ja?ka
pkt	Maleng
mgl	Maleu-Kilenge
mlx	Malfaxal
vml	Malgana
mxf	Malgbe
gcc	Mali
mgq	Malila
mzd	Malimba
mli	Malimpung
tcf	Malinaltepec Tlapanec
mla	Malo
mbk	Malol
mt	Maltese
mdl	Maltese Sign Language
mjt	Malto
mll	Malua Bay
mup	Malvi
mam	Mam
mma	Mama
mhf	Mamaa
wmd	Mamaind?
mmn	Mamanwa
myk	Mamara Senoufo
mqj	Mamasa
mgm	Mambae
mcs	Mambai
mvd	Mamboru
mgr	Mambwe-Lungu
maw	Mampruli
mqx	Mamuju
emm	Mamulique
kdf	Mamusi
mdi	Mamvu
mlc	Man Cao Lan
mml	Man Met
xmm	Manado Malay
mva	Manam
mle	Manambu
nmm	Manangba
znk	Manangkari
mnc	Manchu
mha	Manda
mht	Mandahuaca
mid	Mandaic
btm	Mandailing Batak
art-man	Mandalorian
mhq	Mandan
zmk	Mandandanyi
mdr	Mandar
tbf	Mandara
mqu	Mandari
cmn	Mandarin
mjl	Mandeali
mqr	Mander
man	Mandingo
mnk	Mandinka
mfv	Mandjak
aax	Mandobo Atas
bwp	Mandobo Bawah
jet	Manem
zng	Mang
mem	Mangala
mpc	Mangarayi
mrv	Mangarevan
zns	Mangas
myj	Mangayat
mdj	Mangbetu
mdk	Mangbutu
zme	Mangerr
mmo	Mangga Buang
mqy	Manggarai
mge	Mango
mqc	Mangole
mbh	Mangseng
xmn	Manichaean Middle Persian
xkb	Manigri-Kambol? Ede Nago
mnx	Manikion
mqp	Manipa
mni	Manipuri
knf	Mankanya
mju	Manna-Dora
mjv	Mannan
mev	Mano
woo	Manombai
msk	Mansaka
mns	Mansi
msw	Mansoanka
myg	Manta
nty	Mantsi
kxf	Manumanaw Karen
wha	Manusela
gv	Manx
mzj	Manya
mny	Manyawa
mxc	Manyika
mzv	Manza
nbi	Mao Naga
mmd	Maonan
swb	Maore Comorian
mi	Maori
mlh	Mape
mnm	Mapena
mpy	Mapia
mpw	Mapidian
bzh	Mapos Buang
mcg	Mapoyo
arn	Mapudungun
sjm	Mapun
mch	Maquiritari
mec	Mara
mrh	Mara Chin
lri	Marachi
vmh	Maraghei
mrs	Maragus
nma	Maram Naga
lrm	Marama
myd	Maramba
mrw	Maranao
zmr	Maranunggu
mgb	Mararit
mr	Marathi
mvr	Marau
mpg	Marba
vmr	Marenje
mvu	Marfa
zmc	Margany
mfm	Marghi South
mrt	Margi
mhg	Margu
mds	Maria
mrc	Maricopa
zmd	Maridan
zmj	Maridjabin
dad	Marik
zmm	Marimanindji
mrz	Marind
mbw	Maring
nng	Maring Naga
zmt	Maringarr
mrb	Marino
mqi	Mariri
nsr	Maritime Sign Language
msp	Maritsau?
zmy	Mariyedi
rkm	Marka
enb	Markweeta
rmz	Marma
cpe-mar	Maroon Spirit Language
mvo	Marovo
xru	Marriammu
mfr	Marrithiyel
umc	Marrucinian
mh	Marshallese
ims	Marsian
mre	Martha's Vineyard Sign Language
zmg	Marti Ke
mpj	Martu Wangka
vma	Martuthunira
mzr	Mar?bo
mwr	Marwari
myx	Masaba
tis	Masadiit Itneg
mls	Masalit
mcn	Masana
bks	Masbate Sorsogon
msb	Masbatenyo
cuj	Mashco Piro
mho	Mashi
ism	Masimasi
bnf	Masiwang
klv	Maskelynes
msv	Maslam
mes	Masmaje
wam	Massachusett
mdg	Massalat
mvs	Massep
mtn	Matagalpa
mfh	Matal
xmt	Matbat
mgv	Matengo
mqe	Matepi
mbt	Matigsalug Manobo
mzo	Matipuhy
mpq	Mat?s
met	Mato
axg	Mato Grosso Ar?ra
mtm	Mator
ymt	Mator-Taygi-Karagas
mcf	Mats?s
mvb	Mattole
mjk	Matukar
mgw	Matumbi
stj	Matya Samo
mph	Maung
mfe	Mauritian Creole
lsy	Mauritian Sign Language
mhl	Mauwake
wma	Mawa
mjj	Mawak
mcz	Mawan
mzx	Mawayana
mke	Mawchi
mgk	Mawes
mbl	Maxakal?
mxl	Maxi Gbe
sym	Maya Samo
xmy	Mayaguduna
yan	Mayangna
yxa	Mayawali
ayz	Maybrat
myc	Mayeka
mnt	Maykulan
mfy	Mayo
mdm	Mayogo
ifu	Mayoyao Ifugao
dkx	Mazagway
zpy	Mazaltepec Zapotec
mzn	Mazanderani
vmz	Mazatl?n Mazatec
mzl	Mazatl?n Mixe
mfc	Mba
vmb	Mbabaram
mdp	Mbala
lnb	Mbalanhu
zmz	Mbandja
mxg	Mbangala
mgn	Mbangi
zmn	Mbangwe
mvl	Mbara (Australia)
mpk	Mbara (Chad)
zmv	Mbariman-Gudhinma
mdn	Mbati
gwa	Mbato
myb	Mbay
mfo	Mbe
mtk	Mbe'
mql	Mbelime
mdt	Mbere
zms	Mbesa
mbo	Mbo (Cameroon)
zmw	Mbo (Congo)
moi	Mboi
mdu	Mboko
mdq	Mbole
xmb	Mbonga
bgu	Mbongno
mdw	Mbosi
mxo	Mbowe
mka	Mbre
muc	Mbu'
xmd	Mbudum
mhd	Mbugu
mgz	Mbugwe
mqb	Mbuko
mhw	Mbukushu
mna	Mbula
mbu	Mbula-Bwazza
mlb	Mbule
mbv	Mbulungish
mdd	Mbum
mck	Mbunda
mgy	Mbunga
bbt	Mburku
mfu	Mbwela
gun	Mby? Guaran?
mym	Me'en
meg	Mea
fit	Me?nkieli
mjn	Mebu
mjm	Medebur
mue	Media Lengua
mwx	Mediak
xme	Median
mud	Mednyj Aleut
byv	Medumba
mfj	Mefele
mef	Megam
ruq	Megleno-Romanian
nux	Mehek
mmh	Mehin?ku
gdq	Mehri
mek	Mekeo
mvk	Mekmek
msf	Mekwei
mxe	Mele-Fila
mfx	Melo
med	Melpa
mby	Memoni
xkd	Mendalam Kayan
mfd	Mendankwe-Nkwen
men	Mende
xmg	Mengaka
mee	Mengen
mct	Mengisa
mea	Menka
mez	Menominee
mwv	Mentawai
mcr	Menya
mvx	Meoswar
mnu	Mer
mxm	Meramera
lmb	Merei
meq	Merey
ulk	Meriam
mrm	Merlav
xmr	Meroitic
mer	Meru
iyo	Mesaka
mci	Mese
zim	Mesme
mys	Mesmes
mvz	Mesqan
cms	Messapic
mgo	Meta'
mxv	Metlat?noc Mixtec
wtm	Mewati
mfs	Mexican Sign Language
mej	Meyah
pbe	Mezontla Popoloca
ote	Mezquital Otomi
zmf	Mfinu
nfu	Mfumte
mic	Mi'kmaq
mia	Miami
mpt	Mian
pla	Miani
crg	Michif
cmm	Michigamea
mmc	Michoac?n Mazahua
ncl	Michoac?n Nahuatl
dnt	Mid Grand Valley Dani
bjo	Mid-Southern Banda
axm	Middle Armenian
xbm	Middle Breton
ltc	Middle Chinese
cnx	Middle Cornish
dum	Middle Dutch
enm	Middle English
frm	Middle French
gmh	Middle High German
htx	Middle Hittite
mga	Middle Irish
okm	Middle Korean
gml	Middle Low German
xng	Middle Mongolian
nwx	Middle Newar
gmq-mno	Middle Norwegian
pal	Middle Persian
mkh-mvi	Middle Vietnamese
mpl	Middle Watut
wlm	Middle Welsh
mei	Midob
mmy	Migaama
mpp	Migabac
sjl	Miji
mxj	Miju-Mishmi
mik	Mikasuki
ymh	Mili
mlj	Miltu
iml	Miluk
imy	Milyan
mnp	Min Bei
cdo	Min Dong
nan	Min Nan
czo	Min Zhong
inm	Minaean
xrg	Minang
min	Minangkabau
mcv	Minanibai
mvn	Minaveha
drc	Minderico
mpn	Mindiri
mko	Mingang Doso
iro-min	Mingo
xmf	Mingrelian
hto	Minica Huitoto
wii	Minidien
vmg	Minigir
xjb	Minjungbal
xxm	Minkin
omn	Minoan
mqq	Minokok
mnq	Minriq
mzt	Mintil
zgm	Minz Zhuang
yiq	Miqie
mwl	Mirandese
rbl	Miraya Bikol
mvh	Mire
zrg	Mirgan
mmv	Miriti
mep	Miriwung
pmu	Mirpur Panjabi
mjs	Miship
mpx	Misima-Paneati
mrg	Mising
miq	Miskito
zaw	Mitla Zapotec
vmm	Mitlatongo Mixtec
mwu	Mittu
zmq	Mituku
mpo	Miu
vmi	Miwa
mfg	Mixifore
mix	Mixtepec Mixtec
zpm	Mixtepec Zapotec
mkf	Miya
mvi	Miyako
soy	Miyobe
lus	Mizo
mra	Mlabri
lhs	Mlahs?
kja	Mlap
mlo	Mlomp
mmu	Mmaala
bfm	Mmen
wkd	Mo
gbn	Mo'da
obm	Moabite
mfq	Moba
mod	Mobilian
ahm	Mobumrin Aizi
mhn	M?cheno
old	Mochi
omc	Mochica
mhc	Mocho
moc	Mocov?
mxd	Modang
mqo	Modole
mvq	Moere
mif	Mofu-Gudur
mhj	Mogholi
mou	Mogum
moh	Mohawk
xpq	Mohegan-Pequot
mow	Moi (Congo)
mxn	Moi (Indonesia)
mkp	Moikodi
mwz	Moingi
mov	Mojave
ymi	Moji
mqt	Mok
mwt	Moken
mft	Mokerang
mkj	Mokilese
mkm	Moklen
mkl	Mokole
bri	Mokpwe
vms	Moksela
mdf	Moksha
mbe	Molale
pwm	Molbog
vsi	Moldova Sign Language
bxc	Molengue
mox	Molima
svm	Molise Croatian
aun	Molmo One
zmo	Molo
msl	Molof
mlw	Moloko
ver	Mom Jango
myl	Moma
msz	Momare
dmb	Mombo Dogon
mso	Mombum
mmb	Momina
mqf	Momuna
mnw	Mon
mzg	Monastic Sign Language
mnd	Mond?
npn	Mondropolon
lol	Mongo
mgt	Mongol
mn	Mongolian
msr	Mongolian Sign Language
mog	Mongondow
mjg	Monguor
mnz	Moni
mom	Monimbo
mnr	Mono (California)
mru	Mono (Cameroon)
mnh	Mono (Congo)
moo	Monom
nmh	Monsang Naga
moe	Montagnais
fla	Montana Salish
mtl	Montol
mxk	Monumbo
moj	Monzombo
gwg	Moo
crm	Moose Cree
mop	Mopan Maya
msg	Moraid
mze	Morawa
mos	More
nhm	Morelos Nahuatl
xmo	Morerebi
msx	Moresada
mzq	Mori Atas
xmz	Mori Bawah
mdb	Morigi
mor	Moro
ary	Moroccan Arabic
xms	Moroccan Sign Language
mgc	Morokodo
bdo	Morom
mqn	Moronene
mok	Morori
mrp	Morouas
mrl	Mortlockese
mgd	Moru
mqv	Mosimo
mwy	Mosiro
mtj	Moskona
mtt	Mota
tmv	Motembo
meu	Motu
mwh	Mouk-Aria
kpx	Mountain Koiali
mzp	Movima
ity	Moyadan Itneg
nmo	Moyon Naga
mzy	Mozambican Sign Language
mxi	Mozarabic
mpi	Mpade
xpj	Mpalitjanh
mpz	Mpi
mcx	Mpiemo
mgg	Mpongmpong
mpa	Mpoto
mvt	Mpotovoro
zmp	Mpuono
akc	Mpur
cmr	Mro Chin
mro	Mru
kqx	Mser
atl	Mt. Iraya Agta
agz	Mt. Iriga Agta
mtd	Mualang
tsx	Mubami
mub	Mubi
ymd	Muda
dmw	Mudburra
gau	Mudhili Gadaba
vmd	Mudu Koraga
wiv	Muduapa
udg	Muduga
aoj	Mufian
muk	Mugom
bmr	Muinane
mmk	Mukha-Dora
moz	Mukulu
mfw	Mulaha
mlm	Mulam
kpb	Mullu Kurumba
mpb	Mullukmulluk
vmu	Muluridyi
kqa	Mum
mzm	Mumuye
mwq	M?n Chin
mnb	Muna
unx	Munda
boe	Mundabli
mua	Mundang
mnf	Mundani
unr	Mundari
mmf	Mundat
art-mun	Mundolinco
muh	M?nd?
myu	Munduruk?
mhk	Mungaka
mij	Mungbam
mth	Munggui
mpv	Mungkip
myr	Muniche
mtc	Munit
mnj	Munji
umu	Munsee
mtq	Muong
tkv	Mur Pano
asx	Muratayak
mxr	Murik (Malaysia)
mtf	Murik (New Guinea)
rmh	Murkim
mur	Murle
mwf	Murrinh-Patha
muz	Mursi
huu	Murui Huitoto
mqw	Murupi
zmu	Muruwari
mmq	Musak
mmp	Musan
mmi	Musar
smm	Musasa
mse	Musey
mug	Musgu
xma	Mushungulu
mui	Musi
mje	Muskum
msu	Musom
emi	Mussau-Emira
muv	Muthuvan
tuc	Mutu
mvm	Muya
muy	Muyang
myw	Muyuw
ymz	Muzi
mcj	Mvanip
mxh	Mvuba
wlc	Mwali Comorian
moa	Mwan
wmw	Mwani
mwa	Mwatebu
mwe	Mwera
mws	Mwimbi-Muthambi
mlv	Mwotlap
gmy	Mycenaean Greek
mye	Myene
yms	Mysian
nme	Mzieme Naga
nqo	N'Ko
nbt	Na
neo	N?-Meo
art-nav	Na'vi
nao	Naaba
mne	Naba
naf	Nabak
mty	Nabi
ncd	Nachering
mbj	Nad?b
ndf	Nadruvian
nfr	Nafaanra
srf	Nafi
nxx	Nafri
nag	Naga Pidgin
nbg	Nagarchal
nxe	Nage
ngr	Nagu
ngv	Nagumi
nlx	Nahali
nhh	Nahari
sns	Nahavaq
nah	Nahuatl
bio	Nai
ars	Najdi Arabic
nae	Naka'ela
nkj	Nakai
nib	Nakame
nak	Nakanai
nck	Nakara
nbk	Nake
mff	Naki
nax	Nakwi
nlc	Nalca
nss	Nali
nal	Nalik
nlz	Nal?go
naj	Nalu
ylo	Naluo Yi
naq	Nama
nmk	Namakura
nkm	Namat
nab	Nambikwara
ncm	Nambo
nmq	Nambya
nnm	Namia
nvm	Namiae
nbs	Namibian Sign Language
naa	Namla
mxw	Namo
nmt	Namonuito
bwb	Namosi-Naitasiri-Serua
nmy	Namuyi
gld	Nanai
nnc	Nancere
nnb	Nande
niq	Nandi
sen	Nanerig? S?noufo
nzz	Nanga Dama Dogon
nnk	Nankina
cox	Nanti
nnt	Nanticoke
afk	Nanubae
npy	Napu
npa	Nar Phu
nrb	Nara
nac	Narak
nrg	Narango
nxu	Narau
loh	Narim
nhr	Naro
nrm	Narom
xnt	Narragansett
nru	Narua
nnr	Narungga
nsy	Nasal
nvh	Nasarian
nas	Nasioi
nsk	Naskapi
ywq	Nasu
nts	Natagaimas
ntz	Natanzi
ais	Nataoran Amis
ncz	Natchez
ntm	Nateni
nte	Nathembo
nti	Natioro
ntu	Nat?gu
nxa	Nauete
ynk	Naukanski
ncn	Nauna
nwo	Nauo
na	Nauruan
nv	Navajo
roa-oan	Navarro-Aragonese
nsw	Navut
nwr	Nawaru
nwa	Nawathinehena
nmz	Nawdm
naw	Nawuri
nxq	Naxi
noz	Nayi
nyq	Nayini
ncr	Ncane
nlu	Nchumbulu
nnz	Nda'nda'
gke	Ndai
ndk	Ndaka
ncp	Ndaktup
ndh	Ndali
ndm	Ndam
ndj	Ndamba
nda	Ndasa
ndc	Ndau
ned	Nde-Gbite
ndd	Nde-Nsele-Nta
nml	Ndemli
dne	Ndendeule
ndg	Ndengereko
eli	Nding
ndp	Ndo
ndw	Ndobo
nbb	Ndoe
ndz	Ndogo
ndl	Ndolo
nqm	Ndom
ndq	Ndombe
njd	Ndonde Hamba
ng	Ndonga
ndr	Ndoola
ndx	Nduga
nmd	Ndumu
nuh	Ndunda
ndt	Ndunga
ndv	Ndut
njt	Ndyuka-Trio Pidgin
wni	Ndzwani Comorian
nap	Neapolitan
nec	Nedebang
nef	Nefamese
jbn	Nefusa
dcr	Negerhollands
zmi	Negeri Sembilan Malay
neg	Negidal
nsn	Nehan
nif	Nek
nkg	Nekgini
nej	Neko
nek	Neku
nex	Neme
nem	Nemi
nqn	Nen
anh	Nend
yrk	Nenets
nen	Nengone
neu	Neo
nei	Neo-Hittite
nsp	Nepalese Sign Language
ne	Nepali
kxl	Nepali Kurux
net	Nete
vnm	Neve'ei
jas	New Caledonian Javanese
nzs	New Zealand Sign Language
new	Newari
ney	Neyo
nez	Nez Perce
hlt	Nga La
ntj	Ngaanyatjarra
gym	Ng?bere
nxg	Ngad'a
nju	Ngadjunmaya
nnf	Ngaing
nij	Ngaju
nud	Ngala
nig	Ngalakan
ngk	Ngalkbun
szb	Ngalum
nmc	Ngam
nbv	Ngamambo
sba	Ngambay
nmv	Ngamini
nbh	Ngamo
nam	Ngan'gityemerri
xnk	Nganakarti
nio	Nganasan
nid	Ngandi
nne	Ngandyera
gng	Ngangam
ntg	Ngantangarra
nyx	Nganyaywana
rxd	Ngardi
xni	Ngarigu
nbj	Ngarinman
ung	Ngarinyin
nrk	Ngarla
nrl	Ngarluma
nay	Ngarrindjeri
nsg	Ngasa
ngm	Ngatik Men's Creole
cnw	Ngawn Chin
nxn	Ngawun
zdj	Ngazidja Comorian
nga	Ngbaka
nbm	Ngbaka Ma'bo
ngg	Ngbaka Manza
jgb	Ngbee
nbd	Ngbinda
nuu	Ngbundu
agh	Ngelima
nge	Ngemba
ngt	Ngeq
nnn	Ngete
nbq	Nggem
ngx	Nggwahyi
ngj	Ngie
nnh	Ngiemboon
jle	Ngile
nnq	Ngindo
niy	Ngiti
ngi	Ngizim
kcd	Ngk?lmpw Kanum
nra	Ngom
jgo	Ngomba
nla	Ngombale
nnx	Ngong
noq	Ngongo
ngo	Ngoni
ngq	Ngoreme
nsh	Ngoshie
nlo	Ngul
ngp	Ngulu
nuw	Nguluwan
nui	Ngumbi
xul	Ngunawal
ndn	Ngundi
nue	Ngundu
ngz	Ngungwel
nuo	Ngu?n
nrx	Ngurmbur
ngw	Ngwaba
nwe	Ngwe
ngn	Ngwo
nha	Nhanda
yrl	Nhengatu
hrp	Nhirrpi
nhf	Nhuwala
nia	Nias
bzk	Nicaraguan Creole
ncs	Nicaraguan Sign Language
nie	Niellim
mzk	Nigeria Mambila
pcm	Nigerian Pidgin
nsi	Nigerian Sign Language
nll	Nihali
nii	Nii
nad	Nijadali
gbe	Niksek
nil	Nila
nim	Nilamba
noe	Nimadi
nmp	Nimanbur
nmr	Nimbari
nir	Nimboran
nis	Nimi
niw	Nimo
nmw	Nimoa
shb	Ninam
nxi	Nindi
nby	Ningera
nxr	Ninggerum
niz	Ningil
nns	Ningye
nlk	Ninia Yali
nin	Ninzo
nps	Nipsan
njs	Nisa
nsz	Nisenan
ncg	Nisga'a
yso	Nisi
num	Niuafo'ou
nkp	Niuatoputapu
niu	Niuean
cag	Nivacl?
niv	Nivkh
hrc	Niwer Mil
njl	Njalgulgule
nzb	Njebi
njj	Njen
njr	Njerep
njy	Njyem
nkq	Nkami
nkn	Nkangala
nkz	Nkari
isi	Nkem-Nkum
khu	Nkhumbi
nkc	Nkongho
nko	Nkonya
nkx	Nkoroo
nka	Nkoya
nbo	Nkukoli
nkw	Nkutu
nbp	Nnam
fia	Nobiin
gaw	Nobonob
nom	Nocam?n
njb	Nocte Naga
nog	Nogai
noi	Noiri
nkk	Nokuku
lem	Nomaande
nof	Nomane
not	Nomatsiguenga
nol	Nomlaki
noh	Nomu
zhn	Nong Zhuang
noj	Nonuya
nok	Nooksack
snf	Noon
nhu	Noone
nuk	Nootka
cya	Nopala Chatino
nrc	Noric
roa-nor	Norman
nrn	Norn
nrr	Norra
esi	North Alaskan Inupiatun
mmg	North Ambrym
nks	North Asmat
yir	North Awyu
bcd	North Babar
neq	North Central Mixe
llp	North Efate
fll	North Fali
frr	North Frisian
gis	North Giziga
apc	North Levantine Arabic
mrq	North Marquesan
ayp	North Mesopotamian Arabic
mfk	North Mofu
max	North Moluccan Malay
kti	North Muyu
nni	North Nuaulu
nrp	North Picene
scs	North Slavey
tbg	North Tairora
tnn	North Tanna
whg	North Wahgi
una	North Watut
kiw	Northeast Kiwai
nmu	Northeast Maidu
aee	Northeast Pashayi
dip	Northeastern Dinka
pef	Northeastern Pomo
aqn	Northern Alta
atv	Northern Altai
ryn	Northern Amami-Oshima
bfc	Northern Bai
rbk	Northern Bontok
cts	Northern Catanduanes Bicolano
dgi	Northern Dagara
crl	Northern East Cree
emp	Northern Ember?
ghh	Northern Ghale
gno	Northern Gondi
gbo	Northern Grebo
huj	Northern Guiyang Hmong
hdn	Northern Haida
hno	Northern Hindko
hmi	Northern Huishui Hmong
nrt	Northern Kalapuya
xnn	Northern Kankanay
kxm	Northern Khmer
kqs	Northern Kissi
kmr	Northern Kurdish
lbr	Northern Lorung
lrc	Northern Luri
hmp	Northern Mashan Hmong
ymx	Northern Muji
nd	Northern Ndebele
ngb	Northern Ngbandi
yiv	Northern Nisu
nuv	Northern Nuni
nhy	Northern Oaxaca Nahuatl
cst	Northern Ohlone
onr	Northern One
pao	Northern Paiute
pmq	Northern Pame
pej	Northern Pomo
ncj	Northern Puebla Nahuatl
pmi	Northern Pumi
pww	Northern Pwo
hea	Northern Qiandong Miao
cng	Northern Qiang
nnl	Northern Rengma Naga
rog	Northern Roglai
se	Northern Sami
nsq	Northern Sierra Miwok
nso	Northern Sotho
stb	Northern Subanen
thh	Northern Tarahumara
ntp	Northern Tepehuan
nod	Northern Thai
xtn	Northern Tlaxiaco Mixtec
tsp	Northern Toussian
tji	Northern Tujia
ttm	Northern Tutchone
uzn	Northern Uzbek
ykg	Northern Yukaghir
esk	Northwest Alaska Inupiatun
gya	Northwest Gbaya
mjd	Northwest Maidu
mxa	Northwest Oaxaca Mixtec
glh	Northwest Pashayi
diw	Northwestern Dinka
faz	Northwestern Fars
kfb	Northwestern Kolami
ojb	Northwestern Ojibwa
tmk	Northwestern Tamang
no	Norwegian
nb	Norwegian Bokm?l
nn	Norwegian Nynorsk
nsl	Norwegian Sign Language
bly	Notre
ncf	Notsi
ntw	Nottoway
nwy	Nottoway-Meherrin
nov	Novial
art-nox	Noxilo
noy	Noy
asj	Nsari
nse	Nsenga
nsc	Nshi
nsx	Nsongo
bud	Ntcham
nto	Ntomba
dgt	Ntra'ngith
baf	Nubaca
kcn	Nubi
kte	Nubri
nus	Nuer
nur	Nuguria
noc	Nuk
mbr	Nukak Mak?
klt	Nukna
nuc	Nukuini
nuq	Nukumanu
nnv	Nukunu
xnu	Nukunul
nkr	Nukuoro
nbr	Numana-Nunku-Gbantu-Numbu
nop	Numanggang
sij	Numbami
tgs	Nume
kdk	Numee
nxm	Numidian
nut	Nung
nug	Nungali
nuy	Nunggubuyu
rin	Nungu
npb	Nupbikha
nup	Nupe
hux	N?pode Huitoto
nul	Nusa Laut
nuf	Nusu
nwb	Nyabwa
nev	Nyaheun
cbn	Nyahkur
nyy	Nyakyusa
yly	Ny?layu
nlj	Nyali
nmi	Nyam
nly	Nyamal
now	Nyambo
nwm	Nyamusa-Molo
mwn	Nyamwanga
nym	Nyamwezi
nyk	Nyaneka
nyp	Nyang'i
nyj	Nyanga
nyc	Nyanga-li
nnj	Nyangatom
nyb	Nyangbo
nny	Nyangga
nna	Nyangumarta
nyn	Nyankole
mjh	Nyanza
sev	Nyarafolo Senoufo
mgs	Nyasa
rim	Nyaturu
nyw	Nyaw
nyt	Nyawaygi
nba	Nyemba
nye	Nyengo
neh	Nyenkha
nyl	Nyeu
nyh	Nyigina
nih	Nyiha
nkt	Nyika
nyi	Nyimang
lid	Nyindrou
nyg	Nyindu
njz	Nyishi
xny	Nyiyaparli
nvo	Nyokon
nuj	Nyole
muo	Nyong
nyd	Nyore
nyo	Nyoro
nyv	Nyulnyul
nys	Nyunga
nyu	Nyungwe
nzy	Nzakambay
nzk	Nzakara
nja	Nzanyi
nzi	Nzima
ngh	N?uu
xoc	O'chi'chi'
tyh	O'du
ood	O'odham
bzy	Obanliku
obi	Obispe?o
obl	Oblo
obo	Obo Manobo
afz	Obokuitai
ann	Obolo
obu	Obulom
oca	Ocaina
oc	Occitan
mie	Ocotepec Mixtec
zac	Ocotl?n Zapotec
odk	Od
bhf	Odiai
kkc	Odoodee
odu	Odual
oda	Odut
opy	Ofay?
ofo	Ofo
ogc	Ogbah
ogb	Ogbia
ogg	Ogbogolo
ogu	Ogbronuagum
eri	Ogea
oia	Oirata
oj	Ojibwe
chj	Ojitl?n Chinantec
oka	Okanagan
okn	Oki-No-Erabu
oki	Okiek
ryu	Okinawan
oks	Oko-Eni-Osayen
okj	Oko-Juwoi
okb	Okobo
okd	Okodia
kqv	Okolod
opa	Okpamheri
atg	Okpela
opm	Oksapmin
oku	Oku
xcl	Old Armenian
oav	Old Avar
obt	Old Breton
obr	Old Burmese
roa-oca	Old Catalan
och	Old Chinese
cu	Old Church Slavonic
oco	Old Cornish
gmq-oda	Old Danish
odt	Old Dutch
orv	Old East Slavic
ang	Old English
fro	Old French
ofs	Old Frisian
oge	Old Georgian
goh	Old High German
oht	Old Hittite
ohu	Old Hungarian
sga	Old Irish
roa-oit	Old Italian
ojp	Old Japanese
kaw	Old Javanese
okl	Old Kentish Sign Language
oko	Old Korean
itc-ola	Old Latin
roa-ole	Old Leonese
olt	Old Lithuanian
omp	Old Manipuri
omr	Old Marathi
omx	Old Mon
non	Old Norse
onw	Old Nubian
oos	Old Ossetic
peo	Old Persian
zlw-opl	Old Polish
roa-opt	Old Portuguese
pro	Old Proven?al
prg	Old Prussian
osx	Old Saxon
sem-srb	Old South Arabian
osp	Old Spanish
gmq-osw	Old Swedish
oty	Old Tamil
otb	Old Tibetan
tpw	Old Tupi
otk	Old Turkic
oui	Old Uighur
owl	Old Welsh
ole	Olekha
ong	Olo
olm	Oloma
olr	Olrat
lul	Olu'bo
iko	Olulumo-Ikom
plo	Oluta Popoluca
lto	Olutsotso
lwg	Oluwanga
omg	Omagua
oma	Omaha-Ponca
acx	Omani Arabic
mgx	Omati
omb	Omba
mbm	Ombamba
oml	Ombo
ome	Omejes
nht	Ometepec Nahuatl
omi	Omi
aom	?mie
omk	Omok
omt	Omotik
omu	Omurano
one	Oneida
oog	Ong
oon	?nge
bxe	Ongota
oni	Onin
onx	Onin Based Pidgin
onj	Onjob
ons	Ono
onn	Onobasulu
ono	Onondaga
ont	Ontenu
ojv	Ontong Java
oor	Oorlams
opo	Opao
opt	Opata
lgn	Opuuo
orn	Orang Kanaq
ors	Orang Seletar
sdr	Oraon Sadri
ore	Orej?n
org	Oring
or	Oriya
nlv	Orizaba Nahuatl
orz	Ormu
oru	Ormuri
orx	Oro
orw	Oro Win
oac	Oroch
ora	Oroha
oaa	Orok
okv	Orokaiva
bdu	Oroko
oro	Orokolo
om	Oromo
orh	Oroqen
bpk	Orowe
orr	Oruma
ury	Orya
osa	Osage
ost	Osatu
osc	Oscan
osi	Osing
oso	Ososo
os	Ossetian
otd	Ot Danum
uta	Otank
oti	Oti
otr	Otoro
otw	Ottawa
ota	Ottoman Turkish
otu	Otuke
oum	Ouma
oue	Oune
stn	Owa
wsr	Owenia
owi	Owiniga
oyb	Oy
oyy	Oya'oya
oyd	Oyda
zao	Ozolotepec Zapotec
chz	Ozumac?n Chinantec
pdi	Pa Di
pha	Pa-Hng
pqa	Pa'a
blk	Pa'o Karen
pfa	P??fang
pma	Paama
sig	Paasaal
pcp	Pacahuara
pac	Pacoh
pdo	Padoe
pgn	Paelignian
pbb	P?ez
pgi	Pagi
pae	Pagibete
pgu	Pagu
apf	Pahanan Agta
phr	Pahari-Potwari
lgt	Pahi
phv	Pahlavani
pta	Pai Tavytera
pri	Paic?
ppi	Paipai
pck	Paite Chin
pwn	Paiwan
pkg	Pak-Tong
pkn	Pakanha
pks	Pakistan Sign Language
pku	Paku
kpp	Paku Karen
abw	Pal
plq	Palaic
plr	Palaka Senoufo
cpa	Palantla Chinantec
pfl	Palatinate German
pau	Palauan
pln	Palenquero
pi	Pali
plu	Palikur
pcf	Paliyan
pmd	Pallanganmiddang
fap	Palor
plp	Palpa
ple	Palu'e
plz	Paluan
pmc	Palumata
bpx	Palya Bareli
pmn	Pam
pmb	Pambia
pmk	Pamlico
pmf	Pamona
hih	Pamosu
att	Pamplona Atta
pnz	Pana (Central Africa)
pnq	Pana (West Africa)
lsp	Panamanian Sign Language
par	Panamint
kre	Panar?
pbh	Panare
psn	Panasuan
pwb	Panawa
pnp	Pancana
tdb	Panchpargania
bkj	Pande
pag	Pangasinan
pgs	Pangseng
slm	Pangutaran Sama
pbr	Pangwa
pgg	Pangwali
pnr	Panim
pcg	Paniya
pax	Pankarar?
paz	Pankarar?
pkh	Pankhu
pnc	Pannei
knt	Panoan Katuk?na
pno	Panobo
pnw	Panyjima
ppa	Pao
top	Papantla Totonac
ppn	Papapana
dpp	Papar
pas	Papasena
pbo	Papel
ppe	Papi
pap	Papiamentu
pat	Papitalai
ppu	Papora
gim	Papuan Gimi
pmy	Papuan Malay
moq	Papuan Mor
ppm	Papuma
aap	Par? Ar?ra
gvp	Par? Gavi?o
pzn	Para Naga
prc	Parachi
gug	Paraguayan Guaran?
pys	Paraguayan Sign Language
pak	Parakan?
prf	Paranan
paf	Paranaw?t
pbg	Paraujano
prk	Parauk
prw	Parawen
pch	Pardhan
pcl	Pardhi
ppt	Pare
pab	Pareci
pcj	Parenga
lkr	P?ri
kvx	Parkari Koli
prp	Parsi
prd	Parsi-Dari
xpr	Parthian
paq	Parya
ps	Pashto
psq	Pasi
yac	Pass Valley Yali
pbc	Patamona
ptn	Patani
pth	Patax? H?-Ha-H?e
ptp	Patep
pty	Pathiya
gfk	Patpatar
lae	Pattani
mfa	Pattani Malay
pwi	Patwin
plh	Paulohi
pad	Paumar?
pnk	Paunaca
bfb	Pauri Bareli
psm	Pauserna
pwa	Pawaia
paw	Pawnee
pmr	Paynamar
pai	Pe
pcb	Pear
pay	Pech
xpc	Pecheneg
pfe	Peere
ppq	Pei
pel	Pekal
bxd	Pela
ata	Pele-Ata
ppp	Pelende
aoc	Pemon
pev	P?mono
psg	Penang Sign Language
pek	Penchal
ums	Pendau
peg	Pengo
pdc	Pennsylvania German
aaq	Penobscot
mil	Pe?oles Mixtec
pnh	Penrhyn
ptw	Pentlatch
wet	Perai
pea	Peranakan Indonesian
wom	Perema
pip	Pero
fa	Persian
psc	Persian Sign Language
prl	Peruvian Sign Language
zpe	Petapa Zapotec
pex	Petats
pey	Petjo
lme	P?v?
prt	Phai
phk	Phake
ypa	Phala
phl	Phalura
phq	Phana'
phw	Phangduwali
pem	Phende
psp	Philippine Sign Language
phm	Phimbi
phn	Phoenician
ypg	Phola
yip	Pholo
nph	Phom
pnx	Phong-Kniang
kjt	Phrae Pwo Karen
xpg	Phrygian
pht	Phu Thai
phu	Phuan
phd	Phudagi
pug	Phuie
phh	Phukha
ypm	Phuma
pho	Phunoi
phg	Phuong
ypp	Phupa
yph	Phupha
bnt-phu	Phuthi
ypz	Phuza
ptr	Piamatsina
pin	Piame
pio	Piapoco
pid	Piaroa
pcd	Picard
fpe	Pichinglis
cpu	Pichis Ash?ninka
xpi	Pictish
nai-pic	Picuris
dep	Pidgin Delaware
pms	Piedmontese
pij	Pijao
piz	Pije
pis	Pijin
plg	Pilag?
piv	Pileni
pia	Pima Bajo
piw	Pimbwe
pnn	Pinai-Hagahai
pif	Pingelapese
pii	Pini
pnv	Pinigura
pnj	Pinjarup
pic	Pinji
mio	Pinotepa Nacional Mixtec
pti	Pintiini
piu	Pintupi-Luritja
pny	Pinyin
ppl	Pipil
myp	Pirah?
pir	Piratapuyo
bxi	Pirlatapa
pie	Piro
xpa	Pirriya
pig	Pisabo
tpp	Pisaflores Tepehua
psy	Piscataway
xps	Pisidian
pih	Pitcairn-Norfolk
sje	Pite Sami
pcn	Piti
pjt	Pitjantjatjara
pit	Pitta-Pitta
pix	Piu
piy	Piya-Kwonci
apk	Plains Apache
crk	Plains Cree
psd	Plains Indian Sign Language
pmw	Plains Miwok
ktj	Plapo Krumen
pdt	Plautdietsch
gob	Playero
pbv	Pnar
npo	Pochuri Naga
xpo	Pochutec
pbi	Podoko
poy	Pogolo
pon	Pohnpeian
pok	Pokang?
pof	Poke
pko	P?koot
pox	Polabian
plj	Polci
pl	Polish
pso	Polish Sign Language
plb	Polonombauk
pmo	Pom
zlw-pom	Pomeranian
pmm	Pomo
ncc	Ponam
pod	Ponares
png	Pongu
pns	Ponosakan
pnt	Pontic Greek
poc	Poqomam
poh	Poqomchi'
prh	Porohanon
psw	Port Sandwich
ptv	Port Vato
pt	Portuguese
psr	Portuguese Sign Language
pot	Potawatomi
pog	Potigu?ra
gdb	Pottangi Ollar Gadaba
pmx	Poumei Naga
bye	Pouye
pwr	Powari
pim	Powhatan
pyn	Poyan?wa
prn	Prasuni
pry	Pray
pgl	Primitive Irish
pre	Principense
afa-pro	Proto-Afro-Asiatic
sqj-pro	Proto-Albanian
aql-pro	Proto-Algic
alg-pro	Proto-Algonquian
tut-pro	Proto-Altaic
ine-ana-pro	Proto-Anatolian
hyx-pro	Proto-Armenian
map-ata-pro	Proto-Atayalic
ath-pro	Proto-Athabaskan
aav-pro	Proto-Austro-Asiatic
map-pro	Proto-Austronesian
bat-pro	Proto-Baltic
ine-bsl-pro	Proto-Balto-Slavic
bnt-pro	Proto-Bantu
euq-pro	Proto-Basque
ber-pro	Proto-Berber
cel-bry-pro	Proto-Brythonic
poz-btk-pro	Proto-Bungku-Tolaki
cel-pro	Proto-Celtic
plf-pro	Proto-Central Malayo-Polynesian
aus-cww-pro	Proto-Central New South Wales
poz-cet-pro	Proto-Central-Eastern Malayo-Polynesian
cmc-pro	Proto-Chamic
qfa-cka-pro	Proto-Chukotko-Kamchatkan
cau-cir-pro	Proto-Circassian
azc-cup-pro	Proto-Cupan
dra-pro	Proto-Dravidian
pqe-pro	Proto-Eastern Malayo-Polynesian
poz-pep-pro	Proto-Eastern Polynesian
esx-esk-pro	Proto-Eskimo
esx-pro	Proto-Eskimo-Aleut
fiu-fin-pro	Proto-Finnic
fiu-fpr-pro	Proto-Finno-Permic
fiu-pro	Proto-Finno-Ugric
gem-pro	Proto-Germanic
poz-hce-pro	Proto-Halmahera-Cenderawasih
grk-pro	Proto-Hellenic
hmn-pro	Proto-Hmong
hmx-pro	Proto-Hmong-Mien
inc-pro	Proto-Indo-Aryan
ine-pro	Proto-Indo-European
iir-pro	Proto-Indo-Iranian
esx-inu-pro	Proto-Inuit
ira-pro	Proto-Iranian
itc-pro	Proto-Italic
jpx-pro	Proto-Japonic
ccs-pro	Proto-Kartvelian
qfa-kor-pro	Proto-Korean
poz-lgx-pro	Proto-Lampungic
poz-mly-pro	Proto-Malayic
poz-mcm-pro	Proto-Malayo-Chamic
poz-pro	Proto-Malayo-Polynesian
poz-msa-pro	Proto-Malayo-Sumbawan
hmx-mie-pro	Proto-Mien
mkh-pro	Proto-Mon-Khmer
xgn-pro	Proto-Mongolic
azc-nah-pro	Proto-Nahuan
gmq-pro	Proto-Norse
ccn-pro	Proto-North Caucasian
poz-swa-pro	Proto-North Sarawak
cau-nec-pro	Proto-Northeast Caucasian
cau-nwc-pro	Proto-Northwest Caucasian
poz-pnp-pro	Proto-Nuclear Polynesian
azc-num-pro	Proto-Numic
poz-oce-pro	Proto-Oceanic
aus-pam-pro	Proto-Pama-Nyungan
phi-pro	Proto-Philippine
poz-pol-pro	Proto-Polynesian
dru-pro	Proto-Rukai
sal-pro	Proto-Salish
smi-pro	Proto-Samic
syd-pro	Proto-Samoyedic
sem-pro	Proto-Semitic
sit-pro	Proto-Sino-Tibetan
sio-pro	Proto-Siouan
sca-pro	Proto-Siouan-Catawban
sla-pro	Proto-Slavic
poz-ssw-pro	Proto-South Sulawesi
tai-swe-pro	Proto-Southwestern Tai
poz-sus-pro	Proto-Sunda-Sulawesi
tai-pro	Proto-Tai
azc-tak-pro	Proto-Takic
ine-toc-pro	Proto-Tocharian
tuw-pro	Proto-Tungusic
trk-pro	Proto-Turkic
fiu-ugr-pro	Proto-Ugric
urj-pro	Proto-Uralic
azc-pro	Proto-Uto-Aztecan
mkh-vie-pro	Proto-Vietic
pqw-pro	Proto-Western Malayo-Polynesian
qfa-yen-pro	Proto-Yeniseian
prz	Providencia Sign Language
kvj	Psikye
puk	Pu Ko
cpx	Pu Xian
pux	Puare
atp	Pudtol Atta
pue	Puelche
psl	Puerto Rican Sign Language
npu	Puimei Naga
pui	Puinave
pkp	Pukapuka
pup	Pulabu
puw	Puluwat
pum	Puma
yae	Pum?
xpm	Pumpokol
pud	Punan Aput
pna	Punan Bah-Biau
pnm	Punan Batu
puf	Punan Merah
puc	Punan Merap
puj	Punan Tubu
xpu	Punic
pa	Punjabi
puu	Punu
puo	Puoc
puq	Puquina
pru	Puragi
iar	Purari
pua	Purepecha
prr	Puri
prx	Purik
puy	Purisime?o
pur	Purubor?
pub	Purum
mfl	Putai
put	Putoh
afe	Putukwam
xpp	Puyo-Paekche
pyu	Puyuma
pme	Pwaamei
pop	Pwapwa
kjp	Pwo Eastern Karen
pcw	Pyapun
pye	Pye Krumen
pyy	Pyen
pby	Pyu
kjb	Q'anjob'al
kek	Q'eqchi
laq	Qabiao
byx	Qaqet
qxq	Qashqa'i
xqt	Qatabanian
ymq	Qila Muji
ahg	Qimant
zqe	Qiubei Zhuang
qua	Quapaw
fcs	Quebec Sign Language
yum	Quechan
qu	Quechua
qya	Quenya
otq	Quer?taro Otomi
pxm	Quetzaltepec Mixe
qvy	Queyu
zpj	Quiavicuzas Zapotec
qui	Quileute
qun	Quinault
quq	Quinqui
ztq	Quioquitani-Quier? Zapotec
chq	Quiotepec Chinantec
qyp	Quiripi
rah	Rabha
rad	Rade
xrr	Raetic
raz	Rahambuu
mqk	Rajah Kabunsuwan Manobo
raj	Rajasthani
rjs	Rajbanshi
rji	Raji
rjg	Rajong
gra	Rajput Garasia
rkh	Rakahanga-Manihiki
rki	Rakhine
ral	Ralte
rma	Rama
rai	Ramoaaina
kjx	Ramopa
lje	Rampi
thr	Rana Tharu
rax	Rang
rgk	Rangkas
rnl	Ranglong
rao	Rao
ray	Rapa
rap	Rapa Nui
kyx	Rapoisi
rpt	Rapting
lra	Rara Bakati'
rar	Rarotongan
rac	Rasawa
btn	Ratagnon
rth	Ratahan
rtw	Rathawi
bgd	Rathwi Bareli
rau	Raute
yea	Ravula
rwo	Rawa
raw	Rawang
jnl	Rawat
rwa	Rawo
zor	Ray?n Zoque
rat	Razajerdi
ria	Reang
gir	Red Gelao
atu	Reel
rej	Rejang
ree	Rejang Kayan
rei	Reli
bow	Rema
rmb	Rembarunga
reb	Rembong
rem	Remo
agv	Remontado Agta
rmp	Rempi
lkj	Remun
rel	Rendille
ren	Rengao
mnv	Rennellese
rsi	Rennellese Sign Language
rpn	Repanbitip
rer	Rer Bare
rea	Rerau
pgk	Rerep
res	Reshe
rgr	Res?garo
ret	Retta
rcf	R?union Creole French
rey	Reyesano
ril	Riang
ran	Riantana
rir	Ribun
rie	Rien
rkb	Rikbaktsa
zar	Rinc?n Zapotec
rgu	Ringgou
rri	Ririo
rit	Ritarungo
riu	Riung
snj	Riverain Sango
rod	Rogo
rhg	Rohingya
rmm	Roma
rgn	Romagnol
rmx	Romam
rom	Romani
rge	Romani Greek
ro	Romanian
rms	Romanian Sign Language
rsb	Romano-Serbian
rmv	Romanova
rm	Romansch
rol	Romblomanon
rof	Rombo
rmk	Romkun
cla	Ron
rng	Ronga
ror	Rongga
nbu	Rongmei Naga
rnp	Rongpo
roe	Ronji
rnn	Roon
rga	Roria
rro	Roro
roo	Rotokas
rtm	Rotuman
rug	Roviana
pce	Ruching Palaung
rdb	Rudbari
rui	Rufiji
ruh	Ruga
dru	Rukai
cgg	Rukiga
ruz	Ruma
rbb	Rumai Palaung
klq	Rumu
rna	Runa
rou	Runga
rtc	Rungtu
drg	Rungus
rnw	Rungwa
crp-rsn	Russenorsk
ru	Russian
rsl	Russian Sign Language
rue	Rusyn
rut	Rutul
ruc	Ruuli
rnd	Ruund
rwk	Rwa
ksw	S'gaw Karen
sax	Sa
apb	Sa'a
snv	Sa'ban
scq	Sa'och
sav	Saafi-Saafi
raq	Saam
lsm	Saamia
str	Saanich
sxr	Saaroa
saa	Saba
xsa	Sabaean
bsy	Sabah Bisaya
msi	Sabah Malay
sae	Saban?
spy	Sabaot
sbv	Sabine
pml	Sabir
hvn	Sabu
sbo	Sab?m
quv	Sacapulteco
sck	Sadri
skb	Saek
spd	Saep
saf	Safaliba
apz	Safeyoka
sbk	Safwa
sbm	Sagala
tga	Sagalla
qot	Sahaptin
ssy	Saho
saj	Sahu
aec	Saidi Arabic
xsy	Saisiyat
sjb	Sajau Basap
sch	Sakachep
skm	Sakam
sku	Sakao
skt	Sakata
sak	Sake
skf	Sakirabi?
shq	Sala
slx	Salampasu
slr	Salar
sgu	Salas
slq	Salchuq
sau	Saleman
sbe	Saliba
slc	S?liba
sln	Salinan
sll	Salt-Yui
loe	Saluan
slj	Salum?
qfa-len-slv	Salvadoran Lenca
esn	Salvadoran Sign Language
snx	Sam
smd	Sama
smp	Samaritan
sam	Samaritan Aramaic
tmj	Samarokena
ysd	Samatao
smx	Samba
xsb	Sambali
xab	Sambe
ssx	Samberigi
saq	Samburu
smh	Samei
smq	Samo
sm	Samoan
cpe-spp	Samoan Plantation Pidgin
sgs	Samogitian
swm	Samosa
rav	Sampang
sxm	Samre
stu	Samtao
smv	Samvedi
ztm	San Agust?n Mixtepec Zapotec
zpx	San Baltazar Loxicha Zapotec
hve	San Dionisio del Mar Huave
pow	San Felipe Otlaltepec Popoloca
hue	San Francisco del Mar Huave
mat	San Francisco Matlatzinca
maa	San Jer?nimo Tec?atl Mazatec
poe	San Juan Atzingo Popoloca
mjc	San Juan Colorado Mixtec
zab	San Juan Guelav?a Zapotec
xtj	San Juan Teita Mixtec
pps	San Lu?s Temalacayuca Popoloca
pls	San Marcos Tlalcoyalco Popoloca
trq	San Mart?n Itunyoso Triqui
scf	San Miguel Creole French
mig	San Miguel El Grande Mixtec
xtp	San Miguel Piedras Mixtec
ztu	San Pablo G?il? Zapotec
azg	San Pedro Amuzgos Amuzgo
zpf	San Pedro Quiatoni Zapotec
zpt	San Vicente Coatl?n Zapotec
ayn	Sanaani Arabic
spn	Sanapan?
sad	Sandawe
scg	Sanggau
snl	Sangil
sxn	Sangir
sgr	Sangisari
sgk	Sangkong
sgy	Sanglechi
sg	Sango
nsa	Sangtam Naga
sbp	Sangu
ysn	Sani
ysy	Sanie
sny	Saniyo-Hiyewe
msc	Sankaran Maninka
ssi	Sansi
sa	Sanskrit
ztn	Santa Catarina Albarradas Zapotec
pca	Santa In?s Ahuatempan Popoloca
zpn	Santa In?s Yatzechi Zapotec
mdv	Santa Luc?a Monteverde Mixtec
hvv	Santa Mar?a del Mar Huave
nhz	Santa Mar?a La Alta Nahuatl
zpi	Santa Mar?a Quiegolani Zapotec
mza	Santa Mar?a Zacatepec Mixtec
cok	Santa Teresa Cora
sat	Santali
zpr	Santiago Xanica Zapotec
zas	Santo Domingo Albarradas Zapotec
xsu	Sanum?
zkp	S?o Paulo Kaing?ng
cri	S?otomense
spr	Saparua
spc	Sap?
krn	Sapo
spi	Saponi
sps	Saposa
spu	Sapuan
mwm	Sar
sre	Sara
koj	Sara Dunjo
sbz	Sara Kaba
kwg	Sara Kaba Deme
kwv	Sara Kaba N??
srm	Saramaccan
bps	Sarangani Blaan
mbs	Sarangani Manobo
zsa	Sarasira
sar	Saraveca
srs	Sarcee
sc	Sardinian
srh	Sarikoli
sdf	Sarli
onp	Sartang
swy	Sarua
sdu	Sarudu
sra	Saruga
sas	Sasak
sxs	Sasaru
sdc	Sassarese Sardinian
stw	Satawalese
mav	Sater?-Maw?
stq	Saterland Frisian
sdl	Saudi Arabian Sign Language
skc	Sauk
psu	Sauraseni Prakrit
saz	Saurashtra
srt	Sauri
sao	Sause
ssj	Sausi
svr	Savara
sdg	Savi
svs	Savosavo
szw	Sawai
swr	Saweru
saw	Sawi
swt	Sawila
sxw	Saxwe Gbe
say	Saya
pos	Sayula Popoluca
sco	Scots
gd	Scottish Gaelic
xsc	Scythian
kdg	Seba
sgw	Sebat Bet Gurage
sbx	Seberuang
sib	Sebop
snb	Sebuyau
sec	Sechelt
sey	Secoya
sed	Sedang
tvw	Sedoa
sos	Seeku
sge	Segai
seg	Segeju
sbg	Seget
sfw	Sehwi
ssg	Seimat
hik	Seit-Kaitetu
sek	Sekani
skp	Sekapan
skz	Sekar
skj	Seke
syi	Seki
skx	Seko Padang
sko	Seko Tengah
lip	Sekpele
kgi	Selangor Sign Language
slu	Selaru
sly	Selayar
snw	Selee
spl	Selepet
ona	Selknam
sel	Selkup
sxl	Selonian
slg	Selungai Murut
sws	Seluwasan
nsm	Sema
sea	Semai
sdm	Semandang
szc	Semaq Beri
sbr	Sembakung Murut
sza	Semelai
etz	Semimi
ssm	Semnam
smy	Semnani
xse	Sempan
seh	Sena
seq	Senara S?noufo
syn	Senaya
sej	Sene
see	Seneca
sds	Sened
szg	Sengele
snu	Senggi
spk	Sengo
ssz	Sengseng
sjs	Senhaja De Srair
sni	Sensi
set	Sentani
sez	Senthang Chin
std	Sentinelese
spe	Sepa
spm	Sepen
iws	Sepik Iwam
mbx	Sepik Mari
sry	Sera
skr	Seraiki
sh	Serbo-Croatian
swf	Sere
srr	Serer
sei	Seri
sve	Serili
kqu	Seroa
ser	Serrano
szd	Seru
srw	Serua
srk	Serudung Murut
seu	Serui-Laut
stf	Seta
stm	Setaman
sbi	Seti
sta	Settla
ojs	Severn Ojibwa
sew	Sewa Bay
crs	Seychellois Creole
sze	Seze
scw	Sha
sdb	Shabak
sbf	Shabo
srz	Shahmirzadi
shm	Shahrudi
sha	Shall-Zwall
sqa	Shama-Sambuga
xsh	Shamang
ksb	Shambala
shn	Shan
swo	Shanenawa
sho	Shanga
jih	Shangzhai
mcd	Sharanahua
ssv	Shark Bay
swq	Sharwa
sht	Shasta
shj	Shatt
sqh	Shau
sjw	Shawnee
shx	She
shv	Shehri
moy	Shekkacho
she	Sheko
sth	Shelta
seb	Shempire Senoufo
shl	Shendu
scv	Sheni
bun	Sherbro
sdp	Sherdukpen
xsr	Sherpa
kip	Sheshi Kham
shr	Shi
ssh	Shihhi Arabic
gua	Shiki
shk	Shilluk
scl	Shina
snh	Shinabo
nyr	Shinyiha
shp	Shipibo-Conibo
sxg	Shixing
sle	Sholaga
sii	Shom Peng
sn	Shona
bcv	Shoo-Minda-Nye
cjs	Shor
shh	Shoshone
shg	Shua
sdt	Shuadit
jiv	Shuar
suj	Shubi
sgh	Shughni
sts	Shumashti
scu	Shumcho
shs	Shuswap
ksa	Shuwa-Zamani
shw	Shwai
pll	Shwe Palaung
slw	Sialum
sif	Siamou
spg	Sian
snp	Siane
sya	Siang
sjr	Siar-Lak
nco	Sibe
sdx	Sibu Melanau
sxc	Sicanian
scx	Sicel
ii	Sichuan Yi
scn	Sicilian
sep	S?c?t? S?noufo
sqr	Siculo-Arabic
sid	Sidamo
xsd	Sidetic
erg	Sie
zaa	Sierra de Ju?rez Zapotec
sgx	Sierra Leone Sign Language
nsu	Sierra Negra Nahuatl
sxe	Sighu
snr	Sihan
ski	Sika
sky	Sikaiana
tty	Sikaritai
sik	Sikiana
sip	Sikkimese
skh	Sikule
slt	Sila
mks	Silacayoapan Mixtec
sbq	Sileibi
szl	Silesian
sli	Silesian German
wul	Silimo
mkc	Siliput
xsp	Silopi
stv	Silt'e
sie	Simaa
bts	Simalungun Batak
sbw	Simba
smg	Simbali
smb	Simbari
sbb	Simbo
smz	Simeku
smr	Simeulue
smt	Simte
siu	Sinagen
sst	Sinasina
snc	Sinaugoro
sjn	Sindarin
sd	Sindhi
sbn	Sindhi Bhil
xts	Sindihui Mixtec
sgm	Singa
sls	Singapore Sign Language
sgp	Singpho
si	Sinhalese
xti	Sinicahua Mixtec
skq	Sininkere
snz	Sinsauru
rmo	Sinte Romani
sys	Sinyar
xsi	Sio
snn	Siona
qum	Sipacapense
swj	Sira
fos	Siraya
ysr	Sirenik
sir	Siri
sri	Siriano
srq	Sirion?
srx	Sirmauri
ssd	Siroi
sld	Sissala
sso	Sissano
sis	Siuslaw
siy	Sivandi
siz	Siwa
siw	Siwai
akp	Siwu
csy	Siyin Chin
ska	Skagit
svx	Skalvian
ske	Ske
skw	Skepi Creole Dutch
sms	Skolt Sami
skv	Skou
den	Slavey
sk	Slovak
svk	Slovakian Sign Language
sl	Slovene
zlw-slv	Slovincian
sfm	Small Flowery Miao
kxq	Sm?rky Kanum
sno	Snohomish
sss	S?
ssq	So'a
sob	Sobei
cso	Sochiapam Chinantec
xog	Soga
sog	Sogdian
soj	Soi
skk	Sok
swn	Sokna
soc	Soko
sok	Sokoro
xso	Solano
sby	Soli
aaw	Solong
sol	Solos
smc	Som
so	Somali
bmu	Somba-Siawari
sor	Somrai
smu	Somray
kgt	Somyev
shc	Sonde
sgo	Songa
sop	Songe
csj	Songlai Chin
soo	Songo
soe	Songomeno
sod	Songoora
soi	Sonha
siq	Sonia
snk	Soninke
sov	Sonsorolese
teu	Soo
urw	Sop
sqt	Soqotri
srb	Sora
sbh	Sori-Harengan
sqo	Sorkhei
sxo	Sorothaptic
ays	Sorsogon Ayta
sdk	Sos Kundi
krz	Sota Kanum
st	Sotho
sqq	Sou
sfs	South African Sign Language
aws	South Awyu
lnl	South Central Banda
dib	South Central Dinka
erk	South Efate
fal	South Fali
giz	South Giziga
lmf	South Lembata
ajp	South Levantine Arabic
mqm	South Marquesan
kts	South Muyu
nxl	South Nuaulu
spx	South Picene
xsl	South Slavey
omw	South Tairora
cpy	South Ucayali Ash?ninka
mcy	South Watut
tvk	Southeast Ambrym
vbb	Southeast Babar
ijs	Southeast Ijo
psi	Southeast Pashayi
dks	Southeastern Dinka
zpd	Southeastern Ixtl?n Zapotec
nit	Southeastern Kolami
mxy	Southeastern Nochixtl?n Mixtec
pom	Southeastern Pomo
npl	Southeastern Puebla Nahuatl
tcu	Southeastern Tarahumara
stp	Southeastern Tepehuan
agy	Southern Alta
alt	Southern Altai
ams	Southern Amami-Oshima
bfs	Southern Bai
bcc	Southern Balochi
biv	Southern Birifor
bwq	Southern Bobo Madar?
obk	Southern Bontok
caf	Southern Carrier
bln	Southern Catanduanes Bicolano
dga	Southern Dagaare
crj	Southern East Cree
ghe	Southern Ghale
ggo	Southern Gondi
grj	Southern Grebo
hmy	Southern Guiyang Hmong
hax	Southern Haida
hnd	Southern Hindko
sxk	Southern Kalapuya
ksc	Southern Kalinga
kss	Southern Kisi
kjd	Southern Kiwai
sdh	Southern Kurdish
ysp	Southern Lolopo
lrr	Southern Lorung
luz	Southern Luri
snm	Southern Ma'di
hma	Southern Mashan Hmong
mnn	Southern Mnong
ymc	Southern Muji
nr	Southern Ndebele
nbw	Southern Ngbandi
nik	Southern Nicobarese
nsd	Southern Nisu
nnw	Southern Nuni
css	Southern Ohlone
osu	Southern One
pmz	Southern Pame
peq	Southern Pomo
mit	Southern Puebla Mixtec
slh	Southern Puget Sound Salish
pmj	Southern Pumi
hms	Southern Qiandong Miao
qxs	Southern Qiang
nre	Southern Rengma Naga
zsr	Southern Rincon Zapotec
rgs	Southern Roglai
ssb	Southern Sama
sma	Southern Sami
sbd	Southern Samo
skd	Southern Sierra Miwok
sou	Southern Thai
tix	Southern Tiwa
wib	Southern Toussian
tjs	Southern Tujia
tce	Southern Tutchone
uzs	Southern Uzbek
yux	Southern Yukaghir
gso	Southwest Gbaya
plv	Southwest Palawano
psh	Southwest Pashayi
nwi	Southwest Tanna
vbk	Southwestern Bontok
dik	Southwestern Dinka
fay	Southwestern Fars
hmg	Southwestern Guiyang Hmong
hmh	Southwestern Huishui Hmong
nsv	Southwestern Nisu
tsf	Southwestern Tamang
twr	Southwestern Tarahumara
tla	Southwestern Tepehuan
meh	Southwestern Tlaxiaco Mixtec
sww	Sowa
sow	Sowanda
vmp	Soyaltepec Mazatec
vmq	Soyaltepec Mixtec
es	Spanish
ssp	Spanish Sign Language
spt	Spiti Bhoti
spo	Spokane
squ	Squamish
srn	Sranan Tongo
sci	Sri Lankan Creole Malay
sqs	Sri Lankan Sign Language
zgh	Standard Moroccan Tamazight
sbu	Stod Bhoti
sto	Stoney
szp	Suabo
seo	Suarmin
swp	Suau
sxb	Suba
ssc	Suba-Simbiti
xsj	Subi
sbs	Subiya
sut	Subtiaba
apd	Sudanese Arabic
tgo	Sudest
xsv	Sudovian
sue	Suena
sgi	Suga
sug	Suganga
kzs	Sugut Dusun
swi	Sui
sui	Suki
sub	Suku
suk	Sukuma
syk	Sukur
zsu	Sukurum
szn	Sula
sua	Sulka
srg	Sulod
suv	Sulung
sqm	Suma
siv	Sumariup
six	Sumau
smw	Sumbawa
suw	Sumbwa
sux	Sumerian
csv	Sumtu Chin
ssk	Sunam
su	Sundanese
ymn	Sunum
suz	Sunwar
syo	Suoy
spp	Supyire
tdl	Sur
sur	Sura
sbj	Surbakhal
suq	Suri
sgd	Surigaonon
sjp	Surjapuri
sgz	Sursurunga
swx	Suruah?
sde	Surubu
sru	Suru?
mdz	Suru? Do Par?
sqn	Susquehannock
sus	Susu
ssu	Susuami
sdj	Suundi
swu	Suwawa
suy	Suy?
sva	Svan
swg	Swabian
sw	Swahili
csw	Swampy Cree
ss	Swazi
sv	Swedish
swl	Swedish Sign Language
ssr	Swiss-French Sign Language
sgg	Swiss-German Sign Language
slf	Swiss-Italian Sign Language
shz	Syenara Senoufo
syl	Sylheti
syr	Syriac
sem-syr	Syrian Arabic
tct	T'en
acq	Ta'izzi-Adeni Arabic
tap	Taabwa
zat	Tabaa Zapotec
tby	Tabaru
tab	Tabasaran
chf	Tabasco Chontal
nhc	Tabasco Nahuatl
zoq	Tabasco Zoque
tnm	Tabla
knv	Tabo
tzx	Tabriak
xtt	Tacahua Mixtec
tna	Tacana
shy	Tachawit
dsq	Tadaksahak
tdy	Tadyawan
rob	Tae'
tcd	Tafi
bgs	Tagabawa
klg	Tagakaulu Kalagan
mvv	Tagal Murut
tl	Tagalog
oua	Tagargrent
tbw	Tagbanwa
tbm	Tagbu
tda	Tagdal
tgx	Tagish
tag	Tagoi
tgw	Tagwana Senoufo
thv	Tahaggart Tamahaq
ty	Tahitian
tht	Tahltan
taw	Tai
tyr	Tai Daeng
blt	Tai Dam
tyj	Tai Do
twh	Tai D?n
thc	Tai Hang Tong
tiz	Tai Hongjin
tlq	Tai Loi
thi	Tai Long
tmp	Tai M?ne
tdd	Tai N?a
tpo	Tai Pao
tmm	Tai Thanh
cuu	Tai Ya
gpn	Taiap
aos	Taikat
crp-tpr	Taimyr Pidgin Russian
ago	Tainae
tnq	Taino
uar	Tairuma
dav	Taita
tss	Taiwan Sign Language
pee	Taje
tg	Tajik
abh	Tajiki Arabic
tdj	Tajio
tja	Tajuasohn
tkm	Takelma
tks	Takestani
tbc	Takia
tkz	Takua
nho	Takuu
tke	Takwane
tal	Tal
tak	Tala
tld	Talaud
tlv	Taliabu
tdf	Talieng
tlj	Talinga-Bwisi
tlr	Talise
tlo	Talodi
tlk	Taloki
tln	Talondo'
tzl	Talossan
yta	Talu
tly	Talysh
tma	Tama (Chad)
ten	Tama (Colombia)
tcg	Tamagario
tmz	Tamanaku
tmh	Tamashek
taq	Tamasheq
vmx	Tamazola Mixtec
tdk	Tambas
xxt	Tambora
tls	Tambotalo
kzt	Tambunan Dusun
tmy	Tami
ta	Tamil
tax	Tamki
tml	Tamnim Citak
low	Tampias Lobu
tpu	Tampuan
tpm	Tampulma
tcb	Tanacross
tcm	Tanahmerah
tpv	Tanapag
tgn	Tandaganon
tni	Tandia
tnx	Tanema
tan	Tangale
tnv	Tangchangya
tgg	Tangga
tgu	Tanggu
nmf	Tangkhul Naga
tkx	Tangko
ytl	Tanglang
tgp	Tangoa
nst	Tangsa
tbs	Tanguat
txg	Tangut
tbe	Tanimbili
tnc	Tanimuca-Retuar?
uji	Tanjijili
kml	Tanudan Kalinga
tza	Tanzanian Sign Language
twf	Taos
tbb	Tapeba
afp	Tapei
tpj	Tapiet?
taf	Tapirap?
kcm	Tar Gula
bdh	Tara Baka
roa-tar	Tarantino
tro	Tarao
tgr	Tareng
tae	Tariana
rif	Tarifit
yer	Tarok
trv	Taroko
tpf	Tarpia
txr	Tartessian
twq	Tasawaq
shi	Tashelhit
xtz	Tasmanian
tmt	Tasmate
ttt	Tat
cta	Tataltepec Chatino
txx	Tatana
tt	Tatar
tav	Tatuyo
ttd	Tauade
tuh	Taulil
tco	Taungyo
tpa	Taupota
tad	Tause
trr	Taushiro
tsg	Tausug
tya	Tauya
tvs	Taveta
tvn	Tavoyan
rmu	Tavringer Romani
tbo	Tawala
ttq	Tawallammat Tamajaq
xtw	Tawand?
twm	Tawang Monpa
twl	Tawara
tbp	Taworta
twy	Tawoyan
tcp	Tawr Chin
tyz	T?y
tas	Tay Boi
tnu	Tay Khang
tys	T?y Sa Pa
tyt	T?y Tac
ayy	Tayabas Ayta
thz	Tayart Tamajeq
cks	Tayo
grr	Taznatit
tbl	Tboli
tck	Tchitchege
bqa	Tchumbuli
tve	Te'un
tkw	Teanu
tsy	Tebul Sign Language
dtu	Tebul Ure Dogon
tcw	Tecpatl?n Totonac
tuq	Tedaga
ctd	Tedim Chin
tkq	Tee
lor	T??n
tfo	Tefaro
ras	Tegali
kps	Tehit
teh	Tehuelche
twe	Teiwa
ztt	Tejalapan Zapotec
ebo	Teke-Ebo
ifm	Teke-Fuumu
kkw	Teke-Kukuya
lli	Teke-Laali
nzu	Teke-Nzikou
teg	Teke-Tege
tyi	Teke-Tsaayi
tyx	Teke-Tyee
ttc	Tektiteko
tvm	Tela-Masbuar
tlf	Telefol
te	Telugu
tlt	Teluti
kdh	Tem
tjo	Temacine Tamazight
nhv	Temascaltepec Nahuatl
tqb	Temb?
tdo	Teme
teq	Temein
soz	Temi
tea	Temiar
ott	Temoaya Otomi
tmo	Temoq
tdu	Tempasuk Dusun
tmw	Temuan
otn	Tenango Otomi
dtk	Tene Kan Dogon
vkt	Tenggarong Kutai Malay
tes	Tengger
pah	Tenharim
tqn	Tenino
tns	Tenis
tex	Tennet
tio	Teop
tev	Teor
tep	Tepecano
cnt	Tepetotutla Chinantec
cux	Tepeuxila Cuicatec
cte	Tepinapa Chinantec
ted	Tepo Krumen
sjt	Ter Sami
ttr	Tera
trb	Terebu
buo	Terei
ter	Tereno
tef	Teressa
twg	Tereweng
tfr	Teribe
tec	Terik
twu	Termanu
tft	Ternate
tmg	Ternate?o
keg	Tese
twc	Teshenawa
tll	Tetela
nhg	Tetelcingo Nahuatl
teb	Tetete
tet	Tetum
tdt	Tetun Dili
cut	Teutila Cuicatec
tew	Tewa
twx	Tewe
otx	Texcatepec Otomi
poq	Texistepec Popoluca
zpz	Texmelucan Zapotec
mxb	Tezoatl?n Mixtec
thy	Tha
thn	Thachanadan
tcz	Thado Chin
th	Thai
tsq	Thai Sign Language
soa	Thai Song
cth	Thaiphum Chin
ths	Thakali
nki	Thangal Naga
thf	Thangmi
ssf	Thao
thk	Tharaka
dhr	Tharrgari
xtv	Thawa
typ	Thaypan
thx	The
tou	Tho
thp	Thompson
ytp	Thopho
txh	Thracian
tyl	Thu Lao
thw	Thudam
tdh	Thulung
tbh	Thurawal
thu	Thuri
ahi	Tiagbamrin Aizi
mnl	Tiale
tbj	Tiang
ngy	Tibea
bo	Tibetan
tcn	Tichurong
tca	Ticuna
mtx	Tida? Mixtec
tia	Tidikelt Tamazight
tid	Tidong
tvo	Tidore
tiq	Ti?fo
boo	Tiemac?w? Bozo
tii	Tiene
boz	Ti?yaxo Bozo
tif	Tifal
tgc	Tigak
nza	Tigon Mbembe
tig	Tigre
ti	Tigrinya
txq	Tii
xtl	Tijaltepec Mixtec
tik	Tikar
tkp	Tikopia
otl	Tilapa Otomi
til	Tillamook
zts	Tilquiapan Zapotec
tij	Tilung
tms	Tima
tim	Timbe
tem	Timne
tvy	Timor Pidgin
tjm	Timucua
tih	Timugon Murut
lbf	Tinani
tin	Tindi
tie	Tingal
tgv	Tingui-Boto
tit	Tinigua
tne	Tinoc Kallahan
tpz	Tinputz
tpe	Tippera
tic	Tira
tra	Tirahi
tde	Tiranige Diga Dogon
pyx	Tircul
cir	Tiri
tiy	Tiruray
tdq	Tita
ttv	Titan
tiv	Tivi
lax	Tiwa
tiw	Tiwi
tju	Tjurruru
tpt	Tlachichilco Tepehua
tpl	Tlacoapa Me'phaa
ctl	Tlacoatzintepec Chinantec
zpk	Tlacolulita Zapotec
mxp	Tlahuitoltepec Mixe
nuz	Tlamacazapa Nahuatl
mqh	Tlazoyaltepec Mixtec
tli	Tlingit
toz	To
mlu	To'abaita
tqo	Toaripi
tob	Toba
bbc	Toba Batak
tmf	Toba-Maskoy
tgh	Tobagonian Creole English
tng	Tobanga
tti	Tobati
tlb	Tobelo
tox	Tobian
tgb	Tobilung
tbv	Tobo
asu	Tocantins Asurini
xto	Tocharian A
txb	Tocharian B
taz	Tocho
tcx	Toda
tdr	Todrah
kim	Tofa
tlg	Tofanma
tfi	Tofin Gbe
tor	Togbo-Vara Banda
tgy	Togoyo
toj	Tojolabal
tpi	Tok Pisin
zuh	Tokano
tkl	Tokelauan
art-top	Toki Pona
tkn	Toku-No-Shima
jic	Tol
ksd	Tolai
lbw	Tolaki
tlm	Tolomako
tol	Tolowa
tod	Toma
tdi	Tomadino
ttp	Tombelala
txa	Tombonuo
tom	Tombulu
toe	Tomedes
txm	Tomini
dto	Tommo So Dogon
dtm	Tomo Kan Dogon
tqp	Tomoip
tdn	Tondano
toi	Tonga
to	Tongan
tny	Tongwe
tjn	Tonjon
tqw	Tonkawa
tnw	Tonsawang
txs	Tonsea
tnt	Tontemboan
ttj	Tooro
toy	Topoiyo
toq	Toposa
trz	Tor?
sda	Toraja-Sa'dan
trj	Toram
ttu	Torau
tdv	Toro
dts	Toro So Dogon
dtt	Toro Tegu Dogon
tno	Toromono
tqr	Torona
tcs	Torres Strait Creole
tei	Torricelli
yyu	Torricelli Yau
trw	Torwali
ttl	Totela
txo	Toto
txe	Totoli
zph	Totomachapan Zapotec
mto	Totontepec Mixe
ttk	Totoro
tqu	Touo
neb	Toura
ttn	Towei
mul	Translingual
rmd	Traveller Danish
rmg	Traveller Norwegian
trl	Traveller Scottish
trm	Tregami
tme	Trememb?
stg	Trieng
tip	Trimuris
tgq	Tring
trx	Tringgus
lst	Trinidad and Tobago Sign Language
trf	Trinidadian Creole English
trn	Trinitario
tri	Tri?
tka	Truk?
tpy	Trumai
tsl	Ts'?n-Lao
tsa	Tsaangi
tkr	Tsakhur
tsd	Tsakonian
kvz	Tsakwambo
tsb	Tsamai
huq	Tsat
tsk	Tseku
txc	Tsetsaut
ddo	Tsez
tsj	Tshangla
lua	Tshiluba
kdl	Tsikimba
cas	Tsiman?
tsi	Tsimshian
tsw	Tsishingini
ldp	Tso
hio	Tsoa
tsv	Tsogo
ts	Tsonga
fly	Tsotsitaal
tsu	Tsou
ttz	Tsum
tvd	Tsuvadi
tsh	Tsuvan
tsc	Tswa
tn	Tswana
two	Tswapong
pmt	Tuamotuan
tbu	Tubar
tub	T?batulabal
tuo	Tucano
tuy	Tugen
tzn	Tugun
tuj	Tugutil
khc	Tukang Besi North
bhq	Tukang Besi South
bag	Tuki
tpq	Tukpa
tkd	Tukudede
tkf	Tukumanf?d
tul	Tula
tlu	Tulehu
tey	Tulishi
tcy	Tulu
rak	Tulu-Bohuai
iou	Tuma-Irumu
tmc	Tumak
tum	Tumbuka
kku	Tumi
tmq	Tumleo
xtq	Tumshuqese
tbr	Tumtum
sil	Tumulung Sisaala
mzb	Tumzabt
enh	Tundra Enets
tvu	Tunen
lcm	Tungag
trt	Tunggare
tug	Tunia
tun	Tunica
aeb	Tunisian Arabic
tse	Tunisian Sign Language
tjg	Tunjung
tqq	Tunni
dza	Tunzu
ttf	Tuotomb
tpr	Tupar?
tpn	Tupinamb?
tpk	Tupinikin
tui	Tupuri
trh	Turaka
trd	Turi
twt	Turiw?ra
tuz	Turka
tuv	Turkana
klj	Turkic Khalaj
tr	Turkish
tsm	Turkish Sign Language
tk	Turkmen
tch	Turks And Caicos Creole English
tru	Turoyo
tqm	Turumsa
try	Turung
tus	Tuscarora
tta	Tutelo
ttg	Tutong
tvt	Tutsa Naga
tmi	Tutuba
mtu	Tututepec Mixtec
tuu	Tututni
tvl	Tuvaluan
tyv	Tuvan
ifk	Tuwali Ifugao
tww	Tuwari
bov	Tuwuli
tud	Tux?
tux	Tuxin?wa
tue	Tuyuca
twa	Twana
twn	Twendi
tw	Twi
kcg	Tyap
woa	Tyaraity
tzj	Tz'utujil
tzh	Tzeltal
tzo	Tzotzil
uuu	U
aoz	Uab Meto
uam	Uamu?
ksj	Uare
byc	Ubaghara
uba	Ubang
ubi	Ubi
ubr	Ubir
uby	Ubykh
cpb	Ucayali-Yur?a Ash?ninka
uda	Uda
udi	Udi
ude	Udihe
udm	Udmurt
udu	Uduk
ufi	Ufim
ugn	Ugandan Sign Language
uga	Ugaritic
uge	Ughele
ugo	Ugong
uha	Uhami
uis	Uisai
udj	Ujir
kcf	Ukaan
ukh	Ukhwejo
umi	Ukit
ukp	Ukpe-Bayobiri
akd	Ukpet-Ehom
uk	Ukrainian
ukl	Ukrainian Sign Language
uku	Ukue
ukg	Ukuriguma
ukq	Ukwa
ukw	Ukwuani-Aboh-Ndoni
svb	Ulau-Suain
ulc	Ulch
udl	Uldeme
uli	Ulithian
ull	Ullatan
ulb	Ulukwumi
ulm	Ulumanda'
ulw	Ulwa
ppk	Uma
xky	Uma' Lasan
ulu	Uma' Lung
gdn	Umanakaina
uma	Umatilla
umd	Umbindhamu
xum	Umbrian
ubu	Umbu-Ungu
umr	Umbugarla
umb	Umbundu
umg	Umbuygamu
sju	Ume Sami
upi	Umeda
due	Umiray Dumaget Agta
umm	Umon
umo	Umot?na
ump	Umpila
mtg	Una
unm	Unami
art-una	Unas
unz	Unde Kaili
und	Undetermined
bbn	Uneapa
une	Uneme
xgu	Unggumi
uln	Unserdeutsch
onu	Unua
unu	Unubahe
uok	Uokha
cjh	Upper Chehalis
dna	Upper Grand Valley Dani
pov	Upper Guinea Crioulo
dmg	Upper Kinabatangan
kuu	Upper Kuskokwim
tku	Upper Necaxa Totonac
sxu	Upper Saxon
hsb	Upper Sorbian
tth	Upper Ta'oih
tau	Upper Tanana
tov	Upper Taromi
xup	Upper Umpqua
uro	Ura (New Guinea)
uur	Ura (Vanuatu)
urf	Uradhi
urk	Urak Lawoi'
url	Urali
urm	Urapmin
ura	Urarina
xur	Urartian
urt	Urat
ur	Urdu
urh	Urhobo
uvh	Uri
urg	Urigina
uri	Urim
urx	Urimo
upv	Uripiv-Wala-Rano-Atchin
urc	Urningangg
ure	Uru
urz	Uru-Eu-Wau-Wau
urp	Uru-Pa-In
urn	Uruangnirin
urv	Uruava
urb	Urub?-Kaapor
ugy	Uruguayan Sign Language
uum	Urum
uru	Urumi
usk	Usaghade
wnu	Usan
usa	Usarufa
ush	Ushojo
cuc	Usila Chinantec
usp	Uspanteco
usi	Usui
omo	Utarmbung
ute	Ute
utu	Utu
evh	Uvbie
usu	Uya
duk	Uyajitaya
ug	Uyghur
uz	Uzbek
auz	Uzbeki Arabic
eze	Uzekwe
vaa	Vaagri Booli
vaf	Vafsi
bij	Vaghat-Ya-Bijim-Legeri
vgr	Vaghri
tva	Vaghua
vag	Vagla
vai	Vai
vap	Vaiphei
vae	Vale
vsv	Valencian Sign Language
cvn	Valle Nacional Chinantec
vmv	Valley Maidu
van	Valman
vlp	Valpei
mkt	Vamale
mlr	Vame
xvn	Vandalic
mpr	Vangunu
vam	Vanimo
vau	Vanuma
vao	Vao
vah	Varhadi-Nagpuri
vrs	Varisi
vav	Varli
vas	Vasavi
vaj	Vasekela Bushman
vay	Vayu
ved	Veddah
val	Vehes
vem	Vemgo-Mabas
ve	Venda
vec	Venetian
xve	Venetic
vsl	Venezuelan Sign Language
veo	Venture?o
vep	Veps
vra	Vera'a
xvs	Vestinian
vid	Vidunda
vig	Viemo
vi	Vietnamese
wym	Vilamovian
vil	Vilela
vif	Vili
dyg	Villa Viciosa Agta
svc	Vincentian Creole English
vin	Vinza
vic	Virgin Islands Creole
vis	Vishavan
vit	Viti
vto	Vitou
gev	Viya
rmy	Vlax Romani
vo	Volap?k
xvo	Volscian
kch	Vono
vor	Voro
vro	V?ro
vot	Votic
vum	Vumbu
vnp	Vunapu
vun	Vunjo
msn	Vur?s
vut	Vute
wbm	Wa
wag	Wa'ema
wwa	Waama
wmn	Waamwang
ssn	Waata
wab	Wab
wbb	Wabo
kmx	Waboda
wci	Waci Gbe
wdg	Wadaginam
wbq	Waddar
xwd	Wadi Wadi
kxp	Wadiyara Koli
wdy	Wadjabangayi
wdj	Wadjiginy
wdu	Wadjigu
wrx	Wae Rana
waj	Waffa
wgb	Wagawaga
wga	Wagaya
wbr	Wagdi
waq	Wageman
fad	Wagi
whu	Wahau Kayan
whk	Wahau Kenyah
wgi	Wahgi
wbk	Waigali
wgo	Waigeo
wlk	Wailaki
wlr	Wailapa
wmh	Waima'a
bao	Waimaha
atr	Waimiri-Atroari
wli	Waioli
waw	Waiwai
wja	Waja
wbv	Wajarri
xwj	Wajuk
wav	Waka
wkw	Wakawaka
wbl	Wakhi
waf	Wakon?
lgl	Wala
wlw	Walak
wal	Walamo
nlw	Walangama
wlx	Wali (Ghana)
wll	Wali (Sudan)
wly	Waling
wla	Walio
waa	Walla Walla
wls	Wallisian
wa	Walloon
wmt	Walmajarri
dwl	Walo Kumbe Dogon
wae	Walser German
ola	Walungge
wmo	Wam
wmc	Wamas
wmb	Wambaya
wms	Wambon
wme	Wambule
cou	Wamey
wmi	Wamin
lbq	Wampar
waz	Wampur
wan	Wan
wnb	Wanambre
wnp	Wanap
nnp	Wancho
wbh	Wanda
mfi	Wandala
wad	Wandamen
wnd	Wandarang
wdd	Wandji
hwa	Wan?
wne	Waneci
wyb	Wangaaybuwan-Ngiyambaa
wnm	Wanggamala
wgg	Wangganguru
wng	Wanggom
wky	Wangkayutyuru
xwk	Wangkumara
wbi	Wanji
wbt	Wanman
jub	Wannu
wno	Wano
wnc	Wantoat
wnk	Wanukaka
wny	Wanyi
juk	Wapan
juw	W?pha
wap	Wapishana
wao	Wappo
aml	War-Jaintia
wbf	Wara
tci	W?ra
wba	Warao
wra	Warapu
wrz	Waray
srv	Waray Sorsogon
war	Waray-Waray
wrr	Wardaman
wxw	Wardandi
wrd	Warduji
gae	Warekena
wsa	Warembori
wai	Wares
pav	Wari'
wrs	Waris
wbe	Waritai
wri	Wariyangga
wji	Warji
bgv	Warkay-Bipim
wrl	Warlmanpa
wbp	Warlpiri
wrb	Warluwara
wrn	Warnang
wrp	Waropen
wgy	Warrgamay
wwr	Warrwa
wru	Waru
wrm	Warumungu
wrv	Waruna
wrg	Warungu
hrw	Warwar Feni
wss	Wasa
wac	Wasco-Wishram
gsp	Wasembo
was	Washo
wsk	Waskia
hus	Wastek
wsu	Wasu
wtk	Watakataui
wax	Watam
wth	Wathaurong
wtf	Watiwa
wah	Watubela
kop	Waube
wau	Wauja
wuy	Wauyai
www	Wawa
wow	Wawonii
wxa	Waxianghua
oym	Wayampi
way	Wayana
ctt	Wayanad Chetti
wyr	Wayor?
guc	Wayuu
wob	W? Northern
gxx	W? Southern
wec	W? Western
wed	Wedau
weh	Weh
weu	Welaung
klh	Weliki
cy	Welsh
rmw	Welsh Romani
weo	Wemale
xww	Wemba-Wemba
wem	Weme Gbe
wer	Weri
kvw	Wersing
fbl	West Albay Bikol
nnd	West Ambae
zbw	West Berawan
bbp	West Central Banda
bdr	West Coast Bajau
drn	West Damar
vls	West Flemish
fy	West Frisian
kew	West Kewa
lmj	West Lembata
mqs	West Makian
mss	West Masela
txn	West Tarangan
uve	West Uvean
lia	West-Central Limba
apw	Western Apache
are	Western Arrernte
bgn	Western Balochi
gnw	Western Bolivian Guaran?
brv	Western Bru
mbb	Western Bukidnon Manobo
ikt	Western Canadian Inuktitut
cja	Western Cham
dnw	Western Dani
azn	Western Durango Nahuatl
wyy	Western Fijian
gvr	Western Gurung
ctp	Western Highland Chatino
nhw	Western Huasteca Nahuatl
jmx	Western Juxtlahuaca Mixtec
knj	Western Kanjobal
kza	Western Karaboro
kuf	Western Katu
kyu	Western Kayah
kjq	Western Keres
krw	Western Krahn
ywl	Western Lalu
lcp	Western Lawa
mrd	Western Magar
mlq	Western Maninkakan
mrj	Western Mari
hmw	Western Mashan Hmong
raf	Western Meohang
mut	Western Muria
amw	Western Neo-Aramaic
ojw	Western Ojibwa
pnb	Western Panjabi
pne	Western Penan
pwo	Western Pwo
ssl	Western Sisaala
suc	Western Subanon
tdg	Western Tamang
twb	Western Tawbuid
tqt	Western Totonac
tnb	Western Tunebo
mmr	Western Xiangxi Miao
xwl	Western Xwla Gbe
ybe	Western Yugur
wea	Wewaw
wew	Weyewa
woy	Weyto
giw	White Gelao
mww	White Hmong
lwh	White Lachi
tnp	Whitesands
tua	Wiarumus
mzh	Wich? Lhamt?s G?isnay
mtp	Wich? Lhamt?s Nocten
wlv	Wich? Lhamt?s Vejoz
wic	Wichita
wie	Wik-Epa
wij	Wik-Iiyanh
wif	Wik-Keyangan
wih	Wik-Me'anha
wim	Wik-Mungkan
wig	Wik-Ngathana
wik	Wikalkan
wua	Wikngenchera
wil	Wilawila
win	Winnebago
wnw	Wintu
kst	Winy?
gdr	Wipi
wrh	Wiradhuri
wir	Wiraf?d
wgu	Wirangu
wiu	Wiru
wiy	Wiyot
xwc	Woccon
wog	Wogamusin
woc	Wogeo
wbw	Woi
wyi	Woiwurrung
jod	Wojenaka
wle	Wolane
wod	Wolani
woe	Woleaian
wlo	Wolio
wo	Wolof
wmx	Womo
won	Wongo
cwd	Woods Cree
wor	Woria
kda	Worimi
jud	Worodougou
wro	Worora
wsv	Wotapuri-Katarqalai
wtw	Wotu
noa	Woun Meu
xwo	Written Oirat
wuu	Wu
wud	Wudu
wlu	Wuliwuli
wux	Wulna
bqm	Wumboko
wum	Wumbvu
ywu	Wumeng Nasu
bwn	Wunai Bunu
wub	Wunambal
wur	Wurrugu
yig	Wusa Nasu
bse	Wushi
wsi	Wusi
wut	Wutung
wuh	Wutunhua
wuv	Wuvulu-Aua
wya	Wyandot
zax	Xadani Zapotec
xkr	Xakriab?
xan	Xamtanga
ztg	Xanagu?a Zapotec
ane	X?r?c??
axx	Xaragure
xav	Xavante
xer	Xer?nte
xet	Xet?
xh	Xhosa
hsn	Xiang
sjo	Xibe
too	Xicotepec De Ju?rez Totonac
xin	Xinca
asn	Xing? Asurin?
xiy	Xipaya
xip	Xipin?wa
xii	Xiri
xir	Xiri?na
ywt	Xishanba Lalo
xok	Xokleng
xoo	Xukur?
xwe	Xwela Gbe
iyx	Yaa
muu	Yaaku
ybn	Yaba?na
yar	Yabarana
ybm	Yaben
ybo	Yabong
ekr	Yace
rys	Yaeyama
wfg	Yafi
yxg	Yagara
ygr	Yagaria
yai	Yagnobi
ygm	Yagomi
yad	Yagua
ygw	Yagwoia
ner	Yahadian
rhp	Yahang
ynu	Yahuna
axk	Yaka
ykk	Yakaikeke
yka	Yakan
yak	Yakima
ybh	Yakkha
yky	Yakoma
sah	Yakut
yba	Yala
jal	Yalahatan
xyl	Yalakalore
zpu	Yal?lag Zapotec
ylr	Yalarnnga
nce	Yale
ylb	Yaleba
yal	Yalunka
yag	Y?mana
ymp	Yamap
yam	Yamba
ymb	Yambes
yat	Yambeta
jmd	Yamdena
yme	Yameo
tao	Yami
yaa	Yaminahua
ymg	Yamongeri
yma	Yamphe
ybi	Yamphu
jay	Yan-nhangu
ynn	Yana
yda	Yanda
dym	Yanda Dom Dogon
xyb	Yandjibara
ynd	Yandruwandha
ame	Yanesha'
zyg	Yang Zhuang
yav	Yangben
ynh	Yangho
bsx	Yangkam
jng	Yangman
yng	Yango
ynl	Yangulam
yde	Yangum Dey
ygl	Yangum Gel
ymo	Yangum Mon
kdd	Yankunytjatjara
wca	Yanom?mi
guu	Yanomam?
yns	Yansi
jao	Yanyuwa
yao	Yao
asy	Yaosakor Asmat
yre	Yaour?
yap	Yapese
yev	Yapunda
jaq	Yaqay
yaq	Yaqui
yrw	Yarawata
yrb	Yareba
zae	Yareni Zapotec
yri	Yar?
yxl	Yarli
yry	Yarluyandi
yrs	Yarsun
yko	Yasa
ysc	Yassic
yty	Yatay
zty	Yatee Zapotec
zav	Yatzachi Zapotec
yla	Yaul
yax	Yauma
jau	Yaur
zpb	Yautepec Zapotec
yvt	Yavitero
yva	Yawa
yaw	Yawalapit?
ywn	Yawanawa
yww	Yawarawarga
yby	Yaweyuha
ybx	Yawiyo
ywr	Yawuru
pcc	Yay
xya	Yaygir
yah	Yazgulyam
tlc	Yecuatla Totonac
jei	Yei
ets	Yekhee
ykr	Yekora
yel	Yela
yle	Yele
jel	Yelmek
ylg	Yelogu
ybb	Yemba
jnj	Yemsa
yen	Yendang
yei	Yeni
yec	Yeniche
yra	Yerakai
gop	Yeretuar
yrn	Yerong
yeu	Yerukula
yes	Yeskwa
yss	Yessan-Mayo
yet	Yetfa
yej	Yevanic
yey	Yeyi
yi	Yiddish
yds	Yiddish Sign Language
ydg	Yidgha
yii	Yidiny
yll	Yil
yee	Yimas
yim	Yimchungru Naga
kvu	Yinbaw Karen
yin	Yinchia
yij	Yindjibarndi
yil	Yindjilandji
pib	Yine
yia	Yinggarda
ywg	Yinhawangka
ygi	Yiningayi
kvy	Yintale Karen
yxm	Yinwum
yiy	Yir-Yoront
ljw	Yirandali
yis	Yis
xth	Yitha Yitha
yob	Yoba
gud	Yocobou? Dida
yog	Yogad
ydk	Yoidik
yki	Yoke
yok	Yokuts
yol	Yola
ygs	Yolngu Sign Language
xty	Yoloxochitl Mixtec
pil	Yom
yom	Yombe
yoi	Yonaguni
yno	Yong
zyb	Yongbei Zhuang
yon	Yongkom
zyn	Yongnan Zhuang
yut	Yopno
mts	Yora
yox	Yoron
yo	Yoruba
yos	Yos
mpm	Yosond?a Mixtec
zyj	Youjiang Zhuang
jiu	Youle Jinuo
buh	Younuo Bunu
ytw	Yout Wam
yoy	Yoy
nua	Yuaga
yua	Yucatec Maya
msd	Yucatec Maya Sign Language
yuc	Yuchi
mvg	Yucua?e Mixtec
ycn	Yucuna
yug	Yug
yub	Yugambal
ysl	Yugoslavian Sign Language
ygu	Yugul
yab	Yuhup
yuk	Yuki
yup	Yukpa
ybl	Yukuben
yul	Yulu
esu	Yup'ik
yuq	Yuqui
yuz	Yuracare
yur	Yurok
ljx	Yuru
yui	Yurut?
mab	Yutanduchi Mixtec
yau	Yuwana
yxu	Yuyu
ztx	Zaachila Zapotec
kji	Zabana
ctz	Zacatepec Chatino
nhi	Zacatl?n-Ahuacatl?n-Tepetzintla Nahuatl
zag	Zaghawa
atb	Zaiwa
zkr	Zakhring
zsl	Zambian Sign Language
cbk-zam	Zamboanga Chavacano
zna	Zan Gula
zak	Zanaki
zne	Zande
zau	Zangskari
zah	Zangwal
zpw	Zaniza Zapotec
zro	Z?paro
zap	Zapotec
zaj	Zaramo
zaz	Zari
dje	Zarma
zrp	Zarphatic
zal	Zauzou
zwa	Zay
kxk	Zayein Karen
zay	Zayse-Zergulla
zza	Zazaki
jaj	Zazao
zea	Zealandic
zua	Zeem
dhm	Zemba
nzm	Zeme Naga
xzm	Zemgalian
zeg	Zenag
zen	Zenaga
czn	Zenzontepec Chatino
zhb	Zhaba
xzh	Zhang-Zhung
zhi	Zhire
zhw	Zhoa
za	Zhuang
zia	Zia
zil	Zialo
ziw	Zigula
zik	Zimakani
zmb	Zimba
zib	Zimbabwe Sign Language
zin	Zinza
sih	Zire
zrn	Zirenkel
zir	Ziriya
ziz	Zizilivakan
pto	Zo'?
yzk	Zokhuo
zpq	Zoogocho Zapotec
gbz	Zoroastrian Dari
czt	Zotung Chin
zom	Zou
gnd	Zulgo-Gemzek
zu	Zulu
zuy	Zumaya
jmb	Zumbun
zun	Zuni
zzj	Zuojiang Zhuang
zyp	Zyphe
xam	?Xam
hnh	?Ani
gnk	?Gana
xeg	?Xegwi
huc	?Hoan
aue	?Kx?au??ein
khi-kun	?Kung
nmn	?X??